date,state,positive,negative,death,total,deathIncrease,negativeIncrease,positiveIncrease,totalIncrease
20200520,AK,402,36643,10,37045,0,662,3,665
20200520,AL,12744,151706,517,164450,13,6516,368,6884
20200520,AR,5003,91255,107,96258,5,2477,80,2557
20200520,AS,0,124,0,124,0,0,0,0
20200520,AZ,14897,150538,747,165435,43,3533,331,3864
20200520,CA,84057,1296063,3436,1380120,102,38542,2262,40804
20200520,CO,22482,109355,1257,131837,33,224,280,504
20200520,CT,39017,151701,3529,190718,57,4611,587,5198
20200520,DC,7551,32868,407,40419,7,928,117,1045
20200520,DE,8194,37218,310,45412,6,1123,157,1280
20200520,FL,47471,723877,2173,772705,44,54966,527,55493
20200520,GA,39647,363293,1687,402940,23,23858,926,24784
20200520,GU,165,4807,5,4972,0,134,11,145
20200520,HI,641,45663,17,46304,0,1280,1,1281
20200520,IA,15614,95134,388,110748,16,2835,265,3100
20200520,ID,2476,36091,77,38567,3,477,21,498
20200520,IL,100418,542295,4525,642713,146,18641,2388,21029
20200520,IN,29274,166464,1864,195738,40,5839,569,6408
20200520,KS,8539,62664,178,71203,5,4014,199,4213
20200520,KY,8069,145917,366,153986,0,0,0,0
20200520,LA,35316,250654,2608,285970,27,7619,278,7897
20200520,MA,88970,400983,6066,489953,128,11968,1045,13013
20200520,MD,42323,173007,2123,215330,42,5895,777,6672
20200520,ME,1819,35450,73,37269,0,13358,78,13436
20200520,MI,53009,384063,5060,437072,43,13509,659,14168
20200520,MN,17670,149668,786,167338,29,4862,641,5503
20200520,MO,11232,150752,631,161984,15,7722,152,7874
20200520,MP,21,3796,2,3817,0,0,0,0
20200520,MS,11967,108713,570,120680,16,2657,263,2920
20200520,MT,478,29248,16,29726,0,769,7,776
20200520,NC,20122,257481,702,277603,11,12173,422,12595
20200520,ND,2095,57105,49,59200,4,1368,101,1469
20200520,NE,10846,61289,132,72135,7,1930,221,2151
20200520,NH,3721,47167,182,51749,10,1345,69,1414
20200520,NJ,150399,380944,10747,531343,161,9775,1386,11161
20200520,NM,6192,136054,276,142246,6,4530,96,4626
20200520,NV,7166,84005,373,91171,8,3496,120,3616
20200520,NY,354370,1151466,22976,1505836,133,36572,1525,38097
20200520,OH,29436,260092,1781,289528,61,11442,484,11926
20200520,OK,5532,138839,299,144371,5,5181,43,5224
20200520,OR,3801,98348,144,102149,4,2354,75,2429
20200520,PA,63666,286034,4624,349700,0,0,0,0
20200520,PR,2866,,125,2866,1,0,61,61
20200520,RI,13356,107172,538,120528,6,2877,405,3282
20200520,SC,9056,126007,399,135063,0,0,0,0
20200520,SD,4177,26212,46,30389,0,588,92,680
20200520,TN,18532,335481,309,354013,4,7736,154,7890
20200520,TX,51323,718918,1419,770241,50,23893,1411,25304
20200520,UT,7710,171954,90,179664,10,5316,326,5642
20200520,VA,32908,179718,1074,213144,33,9074,763,9837
20200520,VI,69,1314,6,1409,0,16,0,16
20200520,VT,944,24114,54,25058,0,467,0,467
20200520,WA,18811,274309,1031,293120,29,3785,200,3985
20200520,WI,13413,154300,481,167924,14,6063,528,6591
20200520,WV,1545,79096,69,80641,1,2304,36,2340
20200520,WY,787,18053,11,18840,1,969,21,990
20200519,AK,399,35981,10,36380,0,769,0,769
20200519,AL,12376,145190,504,157566,15,153,290,443
20200519,AR,4923,88778,102,93701,2,8352,110,8462
20200519,AS,0,124,0,124,0,19,0,19
20200519,AZ,14566,147005,704,161571,18,4702,396,5098
20200519,CA,81795,1257521,3334,1339316,32,45279,1365,46644
20200519,CO,22202,109131,1224,131333,9,2574,264,2838
20200519,CT,38430,147090,3472,185520,23,7527,314,7841
20200519,DC,7434,31940,400,39374,8,1385,164,1549
20200519,DE,8037,36095,304,44132,7,1506,168,1674
20200519,FL,46944,668911,2129,717224,56,38941,502,39443
20200519,GA,38721,339435,1664,378156,22,13227,640,13867
20200519,GU,154,4673,5,4827,0,104,0,104
20200519,HI,640,44383,17,45023,0,2978,0,2978
20200519,IA,15349,92299,372,107648,17,4106,394,4500
20200519,ID,2455,35614,74,38069,1,1361,36,1397
20200519,IL,98030,523654,4379,621684,145,16898,1545,18443
20200519,IN,28705,160625,1824,189330,59,4968,450,5418
20200519,KS,8340,58650,173,66990,0,0,0,0
20200519,KY,8069,145917,366,153986,32,23920,381,24301
20200519,LA,35038,243035,2581,278073,18,7996,329,8325
20200519,MA,87925,389015,5938,476940,141,14199,1915,16114
20200519,MD,41546,167112,2081,208658,58,5368,1784,7152
20200519,ME,1741,22092,73,23833,2,0,28,28
20200519,MI,52350,370554,5017,422904,102,12291,435,12726
20200519,MN,17029,144806,757,161835,17,4572,657,5229
20200519,MO,11080,143030,616,154110,11,2637,135,2772
20200519,MP,21,3796,2,3817,0,397,0,397
20200519,MS,11704,106056,554,117760,26,1721,272,1993
20200519,MT,471,28479,16,28950,0,782,1,783
20200519,NC,19700,245308,691,265008,30,8576,677,9253
20200519,ND,1994,55737,45,57731,1,1107,63,1170
20200519,NE,10625,59359,125,69984,2,2206,277,2483
20200519,NH,3652,45822,172,50348,0,4540,56,4596
20200519,NJ,149013,371169,10586,520182,151,13639,974,14613
20200519,NM,6096,131524,270,137620,5,4209,158,4367
20200519,NV,7046,80509,365,87555,15,5583,140,5723
20200519,NY,352845,1114894,22843,1467739,114,26708,1474,28182
20200519,OH,28952,248650,1720,277602,63,5255,498,5753
20200519,OK,5489,133658,294,139147,6,15496,91,15587
20200519,OR,3726,95994,140,99720,2,2366,39,2405
20200519,PA,63666,286034,4624,349700,119,8481,610,9091
20200519,PR,2805,,124,2805,0,0,95,95
20200519,RI,12951,104295,532,117246,26,1706,156,1862
20200519,SC,9056,126007,399,135063,8,3390,114,3504
20200519,SD,4085,25624,46,29709,2,606,58,664
20200519,TN,18378,327745,305,346123,4,8328,367,8695
20200519,TX,49912,695025,1369,744937,22,20705,1219,21924
20200519,UT,7384,166638,80,174022,0,0,0,0
20200519,VA,32145,170644,1041,203262,27,5558,1005,6563
20200519,VI,69,1298,6,1384,0,20,0,20
20200519,VT,944,23647,54,24591,0,762,4,766
20200519,WA,18611,270524,1002,289135,1,3714,178,3892
20200519,WI,12885,148237,467,161333,8,3735,198,3933
20200519,WV,1509,76792,68,78301,1,2248,18,2266
20200519,WY,766,17084,10,17850,2,753,12,765
20200518,AK,399,35212,10,35611,0,957,3,960
20200518,AL,12086,145037,489,157123,1,458,315,773
20200518,AR,4813,80426,100,85239,2,0,54,54
20200518,AS,0,105,0,105,0,0,0,0
20200518,AZ,14170,142303,686,156473,6,4479,233,4712
20200518,CA,80430,1212242,3302,1292672,41,55838,1591,57429
20200518,CO,21938,106557,1215,128495,23,2642,305,2947
20200518,CT,38116,139563,3449,177679,41,6375,697,7072
20200518,DC,7270,30555,392,37825,9,1152,147,1299
20200518,DE,7869,34589,297,42458,7,1394,199,1593
20200518,FL,46442,629970,2073,677758,24,23766,854,24620
20200518,GA,38081,326208,1642,364289,36,12734,380,13114
20200518,GU,154,4569,5,4723,0,119,0,119
20200518,HI,640,41405,17,42045,0,370,1,371
20200518,IA,14955,88193,355,103148,4,2603,304,2907
20200518,ID,2419,34253,73,36672,0,0,0,0
20200518,IL,96485,506756,4234,603241,57,19003,2294,21297
20200518,IN,28255,155657,1765,183912,14,6192,477,6669
20200518,KS,8340,58650,173,66990,1,4944,454,5398
20200518,KY,7688,121997,334,129685,0,0,0,0
20200518,LA,34709,235039,2563,269748,72,4301,277,4578
20200518,MA,86010,374816,5797,460826,0,0,0,0
20200518,MD,39762,161744,2023,201506,31,5622,958,6580
20200518,ME,1713,22092,71,23805,1,0,26,26
20200518,MI,51915,358263,4915,410178,24,12447,773,13220
20200518,MN,16372,140234,740,156606,9,5317,704,6021
20200518,MO,10945,140393,605,151338,11,4927,156,5083
20200518,MP,21,3399,2,3420,0,81,0,81
20200518,MS,11432,104335,528,115767,7,2505,136,2641
20200518,MT,470,27697,16,28167,0,1280,2,1282
20200518,NC,19023,236732,661,255755,2,6300,511,6811
20200518,ND,1931,54630,44,56561,1,1309,31,1340
20200518,NE,10348,57153,123,67501,0,1733,128,1861
20200518,NH,3596,41282,172,46359,1,86,40,126
20200518,NJ,148039,357530,10435,505569,79,16299,1705,18004
20200518,NM,5938,127315,265,133253,6,4588,81,4669
20200518,NV,6906,74926,350,81832,1,1146,49,1195
20200518,NY,351371,1088186,22729,1439557,110,24911,1250,26161
20200518,OH,28454,243395,1657,271849,32,6856,531,7387
20200518,OK,5398,118162,288,123560,0,0,88,88
20200518,OR,3687,93628,138,97315,1,2895,64,2959
20200518,PA,63056,277553,4505,340609,87,6883,822,7705
20200518,PR,2710,,124,2710,1,0,64,64
20200518,RI,12795,102589,506,115384,7,2713,121,2834
20200518,SC,8942,122617,391,131559,11,10947,281,11228
20200518,SD,4027,25018,44,29045,0,446,40,486
20200518,TN,18011,319417,301,337428,3,11525,623,12148
20200518,TX,48693,674320,1347,723013,11,28828,909,29737
20200518,UT,7384,166638,80,174022,0,3124,146,3270
20200518,VA,31140,165086,1014,196756,5,5113,752,5865
20200518,VI,69,1278,6,1392,0,0,0,0
20200518,VT,940,22885,54,23825,0,1543,0,1543
20200518,WA,18433,266810,1001,285243,1,-3667,-157,-3824
20200518,WI,12687,144502,459,157383,6,4828,144,4972
20200518,WV,1491,74544,67,76035,0,544,1,545
20200518,WY,754,16331,8,17085,0,0,0,0
20200517,AK,396,34255,10,34651,0,1366,4,1370
20200517,AL,11771,144579,488,156350,3,2608,248,2856
20200517,AR,4759,80426,98,85185,0,3360,181,3541
20200517,AS,0,105,0,105,0,0,0,0
20200517,AZ,13937,137824,680,151761,1,4667,306,4973
20200517,CA,78839,1156404,3261,1235243,57,54071,2046,56117
20200517,CO,21633,103915,1192,125548,42,3307,401,3708
20200517,CT,37419,133188,3408,170607,69,5136,716,5852
20200517,DC,7123,29403,383,36526,8,913,81,994
20200517,DE,7670,33195,290,40865,4,984,123,1107
20200517,FL,45588,606204,2049,653271,9,20968,777,21745
20200517,GA,37701,313474,1606,351175,14,29552,554,30106
20200517,GU,154,4450,5,4604,0,85,0,85
20200517,HI,639,41035,17,41674,0,790,1,791
20200517,IA,14651,85590,351,100241,5,3618,323,3941
20200517,ID,2419,34253,73,36672,0,954,30,984
20200517,IL,94191,487753,4177,581944,48,18561,1734,20295
20200517,IN,27778,149465,1751,177243,10,5387,498,5885
20200517,KS,7886,53706,172,61592,0,0,0,0
20200517,KY,7688,121997,334,129685,2,1707,244,1951
20200517,LA,34432,230738,2491,265170,12,5113,315,5428
20200517,MA,86010,374816,5797,460826,92,11660,1077,12737
20200517,MD,38804,156122,1992,194926,35,3915,836,4751
20200517,ME,1687,22092,70,23779,0,0,39,39
20200517,MI,51142,345816,4891,396958,11,38399,638,39037
20200517,MN,15668,134917,731,150585,22,6605,699,7304
20200517,MO,10789,135466,594,146255,5,6801,114,6915
20200517,MP,21,3318,2,3339,0,0,0,0
20200517,MS,11296,101830,521,113126,11,4477,173,4650
20200517,MT,468,26417,16,26885,0,794,0,794
20200517,NC,18512,230432,659,248944,7,9828,530,10358
20200517,ND,1900,53321,43,55221,1,1682,52,1734
20200517,NE,10220,55420,123,65640,4,5214,448,5662
20200517,NH,3556,41196,171,45968,12,1984,92,2076
20200517,NJ,146334,341231,10356,487565,107,11096,1245,12341
20200517,NM,5857,122727,259,128584,6,3931,195,4126
20200517,NV,6857,73780,349,80637,4,6778,195,6973
20200517,NY,350121,1063275,22619,1413396,141,32790,1889,34679
20200517,OH,27923,236539,1625,264462,15,17311,449,17760
20200517,OK,5310,118162,288,123472,0,0,73,73
20200517,OR,3623,90733,137,94356,0,2146,11,2157
20200517,PA,62234,270670,4418,332904,15,4445,623,5068
20200517,PR,2646,,123,2646,1,0,57,57
20200517,RI,12674,99876,499,112550,10,3830,240,4070
20200517,SC,8661,111670,380,120331,0,10461,254,10715
20200517,SD,3987,24572,44,28559,0,355,28,383
20200517,TN,17388,307892,298,325280,3,4979,100,5079
20200517,TX,47784,645492,1336,693276,31,14020,785,14805
20200517,UT,7238,163514,80,170752,2,3808,170,3978
20200517,VA,30388,159973,1009,190888,7,4088,705,4793
20200517,VI,69,1278,6,1392,0,84,0,84
20200517,VT,940,21342,54,22282,1,0,6,6
20200517,WA,18590,270477,1000,289067,8,409,5,414
20200517,WI,12543,139674,453,152399,0,5468,356,5824
20200517,WV,1490,74000,67,75490,3,2064,33,2097
20200517,WY,754,16331,8,17085,1,653,38,691
20200516,AK,392,32889,10,33281,0,859,4,863
20200516,AL,11523,141971,485,153494,9,7124,307,7431
20200516,AR,4578,77066,98,81644,0,0,115,115
20200516,AS,0,105,0,105,0,0,0,0
20200516,AZ,13631,133157,679,146788,28,4325,462,4787
20200516,CA,76793,1102333,3204,1179126,96,43363,1857,45220
20200516,CO,21232,100608,1150,121840,59,3416,394,3810
20200516,CT,36703,128052,3339,164755,54,8229,618,8847
20200516,DC,7042,28490,375,35532,7,1022,171,1193
20200516,DE,7547,32211,286,39758,15,1306,174,1480
20200516,FL,44811,585236,2040,631723,49,19609,1601,21210
20200516,GA,37147,283922,1592,321069,35,18729,466,19195
20200516,GU,154,4365,5,4519,0,4,0,4
20200516,HI,638,40245,17,40883,0,2106,1,2107
20200516,IA,14328,81972,346,96300,10,2455,279,2734
20200516,ID,2389,33299,73,35688,1,905,38,943
20200516,IL,92457,469192,4129,561649,71,20959,2088,23047
20200516,IN,27280,144078,1741,171358,50,5285,625,5910
20200516,KS,7886,53706,172,61592,0,0,0,0
20200516,KY,7444,120290,332,127734,4,6237,219,6456
20200516,LA,34117,225625,2479,259742,31,6273,280,6553
20200516,MA,84933,363156,5705,448089,113,10898,1512,12410
20200516,MD,37968,152207,1957,190175,46,6367,982,7349
20200516,ME,1648,22092,70,23740,1,0,45,45
20200516,MI,50504,307417,4880,357921,55,0,425,425
20200516,MN,14969,128312,709,143281,17,7883,729,8612
20200516,MO,10675,128665,589,139340,13,4663,219,4882
20200516,MP,21,3318,2,3339,0,12,2,14
20200516,MS,11123,97353,510,108476,17,1331,322,1653
20200516,MT,468,25623,16,26091,0,671,2,673
20200516,NC,17982,220604,652,238586,11,6186,853,7039
20200516,ND,1848,51639,42,53487,0,1685,87,1772
20200516,NE,9772,50206,119,59978,6,2407,356,2763
20200516,NH,3464,39212,159,44077,0,64,0,64
20200516,NJ,145089,330135,10249,475224,111,11068,1184,12252
20200516,NM,5662,118796,253,124458,11,4698,159,4857
20200516,NV,6662,67002,345,73664,6,1470,48,1518
20200516,NY,348232,1030485,22478,1378717,174,38250,2419,40669
20200516,OH,27474,219228,1610,246702,29,0,520,520
20200516,OK,5237,118162,288,123399,3,5056,151,5207
20200516,OR,3612,88587,137,92199,0,2622,71,2693
20200516,PA,61611,266225,4403,327836,61,7015,989,8004
20200516,PR,2589,,122,2589,0,0,47,47
20200516,RI,12434,96046,489,108480,10,3287,215,3502
20200516,SC,8407,101209,380,109616,0,0,0,0
20200516,SD,3959,24217,44,28176,0,690,72,762
20200516,TN,17288,302913,295,320201,5,10127,318,10445
20200516,TX,46999,631472,1305,678471,33,30678,1801,32479
20200516,UT,7068,159706,78,166774,1,3401,155,3556
20200516,VA,29683,155885,1002,186053,25,6543,1011,7554
20200516,VI,69,1194,6,1300,0,0,0,0
20200516,VT,934,21342,53,22276,0,-930,1,-929
20200516,WA,18585,270068,992,288653,9,1286,30,1316
20200516,WI,12187,134206,453,146582,8,5549,502,6051
20200516,WV,1457,71936,64,73393,2,2441,16,2457
20200516,WY,716,15678,7,16394,0,371,1,372
20200515,AK,388,32030,10,32418,0,655,1,656
20200515,AL,11216,134847,476,146063,9,3830,248,4078
20200515,AR,4463,77066,98,81529,1,5484,227,5711
20200515,AS,0,105,0,105,0,0,0,0
20200515,AZ,13169,128832,651,142001,27,7168,495,7663
20200515,CA,74936,1058970,3108,1133906,76,27483,1772,29255
20200515,CO,20838,97192,1091,118030,29,3148,363,3511
20200515,CT,36085,119823,3285,155908,66,5725,621,6346
20200515,DC,6871,27468,368,34339,10,1205,135,1340
20200515,DE,7373,30905,271,38278,11,1271,150,1421
20200515,FL,43210,565627,1991,610065,43,0,0,0
20200515,GA,36681,265193,1557,301874,30,15170,823,15993
20200515,GU,154,4361,5,4515,0,135,1,136
20200515,HI,637,38139,17,38776,0,-104,-1,-105
20200515,IA,14049,79517,336,93566,18,3898,374,4272
20200515,ID,2351,32394,72,34745,3,964,27,991
20200515,IL,90369,448233,4058,538602,130,24133,2432,26565
20200515,IN,26655,138793,1691,165448,45,4607,602,5209
20200515,KS,7886,53706,172,61592,8,3546,418,3964
20200515,KY,7225,114053,328,121278,2,3738,145,3883
20200515,LA,33837,219352,2448,253189,31,5253,348,5601
20200515,MA,83421,352258,5592,435679,110,10079,1239,11318
20200515,MD,36986,145840,1911,182826,45,3289,1083,4372
20200515,ME,1603,22092,69,23695,0,0,38,38
20200515,MI,50079,307417,4825,357496,38,21116,497,21613
20200515,MN,14240,120429,692,134669,29,5112,805,5917
20200515,MO,10456,124002,576,134458,14,7209,139,7348
20200515,MP,19,3306,2,3325,0,0,0,0
20200515,MS,10801,96022,493,106823,13,1179,318,1497
20200515,MT,466,24952,16,25418,0,865,4,869
20200515,NC,17129,214418,641,231547,26,11657,622,12279
20200515,ND,1761,49954,42,51715,2,1355,114,1469
20200515,NE,9416,47799,113,57215,6,3533,341,3874
20200515,NH,3464,39148,159,43155,9,3272,165,3437
20200515,NJ,143905,319067,10138,462972,192,10075,1201,11276
20200515,NM,5503,114098,242,119601,11,4451,139,4590
20200515,NV,6614,65532,339,72146,8,2547,115,2662
20200515,NY,345813,992235,22304,1338048,134,36529,2762,39291
20200515,OH,26954,219228,1581,246182,47,12233,597,12830
20200515,OK,5086,113106,285,118192,1,5885,124,6009
20200515,OR,3541,85965,137,89506,0,5394,62,5456
20200515,PA,60622,259210,4342,319832,124,7651,986,8637
20200515,PR,2542,,122,2542,5,0,115,115
20200515,RI,12219,92759,479,104978,11,3174,203,3377
20200515,SC,8407,101209,380,109616,9,6863,218,7081
20200515,SD,3887,23527,44,27414,1,846,95,941
20200515,TN,16970,292786,290,309756,3,7168,271,7439
20200515,TX,45198,600794,1272,645992,56,21361,1347,22708
20200515,UT,6913,156305,77,163218,2,2935,164,3099
20200515,VA,28672,149342,977,178472,22,10325,859,11184
20200515,VI,69,1194,6,1300,0,30,0,30
20200515,VT,933,22272,53,23205,0,699,1,700
20200515,WA,18555,268782,983,287337,8,4185,130,4315
20200515,WI,11685,128657,445,140533,11,6059,410,6469
20200515,WV,1441,69495,62,70936,2,2209,14,2223
20200515,WY,715,15307,7,16022,0,578,14,592
20200514,AK,387,31375,10,31762,0,1109,4,1113
20200514,AL,10968,131017,467,141985,18,5262,351,5613
20200514,AR,4236,71582,97,75818,2,2531,72,2603
20200514,AS,0,105,0,105,0,0,0,0
20200514,AZ,12674,121664,624,134338,30,6090,498,6588
20200514,CA,73164,1031487,3032,1104651,98,37036,2023,39059
20200514,CO,20475,94044,1062,114519,53,2951,318,3269
20200514,CT,35464,114098,3219,149562,94,6010,609,6619
20200514,DC,6736,26263,358,32999,8,1189,152,1341
20200514,DE,7223,29634,260,36857,13,1833,271,2104
20200514,FL,43210,565627,1948,610065,50,13266,808,14074
20200514,GA,35858,250023,1527,285881,22,11451,526,11977
20200514,GU,153,4226,5,4379,0,116,1,117
20200514,HI,638,38243,17,38881,0,513,3,516
20200514,IA,13675,75619,318,89294,12,3189,386,3575
20200514,ID,2324,31430,69,33754,0,595,31,626
20200514,IL,87937,424100,3928,512037,136,19439,3239,22678
20200514,IN,26053,134186,1646,160239,27,5576,580,6156
20200514,KS,7468,50160,164,57628,0,0,0,0
20200514,KY,7080,110315,326,117395,5,6534,227,6761
20200514,LA,33489,214099,2417,247588,36,8857,827,9684
20200514,MA,82182,342179,5482,424361,167,12644,1685,14329
20200514,MD,35903,142551,1866,178454,57,3789,1091,4880
20200514,ME,1565,22092,69,23657,3,0,50,50
20200514,MI,49582,286301,4787,335883,73,26432,1191,27623
20200514,MN,13435,115317,663,128752,25,6199,518,6717
20200514,MO,10317,116793,562,127110,20,2793,175,2968
20200514,MP,19,3306,2,3325,0,285,0,285
20200514,MS,10483,94843,480,105326,15,4885,393,5278
20200514,MT,462,24087,16,24549,0,697,0,697
20200514,NC,16507,202761,615,219268,18,8120,691,8811
20200514,ND,1647,48599,40,50246,0,1301,0,1301
20200514,NE,9075,44266,107,53341,4,3233,383,3616
20200514,NH,3299,35876,150,39910,8,1899,60,1959
20200514,NJ,142704,308992,9946,451696,244,9102,1144,10246
20200514,NM,5364,109647,231,115011,12,4570,152,4722
20200514,NV,6499,62985,331,69484,10,2707,105,2812
20200514,NY,343051,955706,22170,1298757,157,37460,2390,39850
20200514,OH,26357,206995,1534,233352,51,6862,636,7498
20200514,OK,4962,107221,284,112183,6,2946,110,3056
20200514,OR,3479,80571,137,84050,3,0,63,63
20200514,PA,59636,251559,4218,311195,275,7388,938,8326
20200514,PR,2427,,117,2427,2,0,98,98
20200514,RI,12016,89585,468,101601,6,3498,181,3679
20200514,SC,8189,94346,371,102535,16,9133,262,9395
20200514,SD,3792,22681,43,26473,4,569,60,629
20200514,TN,16699,285618,287,302317,14,9071,329,9400
20200514,TX,43851,579433,1216,623284,58,34405,1448,35853
20200514,UT,6749,153370,75,160119,0,3204,129,3333
20200514,VA,27813,139017,955,167326,28,4371,1067,5438
20200514,VI,69,1164,6,1278,0,36,0,36
20200514,VT,932,21573,53,22505,0,826,3,829
20200514,WA,18425,264597,975,283022,13,4920,225,5145
20200514,WI,11275,122598,434,134042,13,5487,373,5860
20200514,WV,1427,67286,60,68713,2,2004,29,2033
20200514,WY,701,14729,7,15430,0,345,26,371
20200513,AK,383,30266,10,30649,0,688,0,688
20200513,AL,10617,125755,449,136372,20,2847,307,3154
20200513,AR,4164,69051,95,73215,0,2771,0,2771
20200513,AS,0,105,0,105,0,0,0,0
20200513,AZ,12176,115574,594,127750,32,4468,440,4908
20200513,CA,71141,994451,2934,1065592,87,30463,1759,32222
20200513,CO,20157,91093,1009,111250,22,2315,278,2593
20200513,CT,34855,108088,3125,142943,84,3997,522,4519
20200513,DC,6584,25074,350,31658,14,509,99,608
20200513,DE,6952,27801,247,34753,10,1251,211,1462
20200513,FL,42402,552361,1898,595954,49,14680,479,15159
20200513,GA,35332,238572,1505,273904,44,11028,697,11725
20200513,GU,152,4110,5,4262,0,171,0,171
20200513,HI,635,37730,17,38365,0,425,1,426
20200513,IA,13289,72430,306,85719,17,4054,377,4431
20200513,ID,2293,30835,69,33128,-1,390,33,423
20200513,IL,84698,404661,3792,489359,191,15991,1677,17668
20200513,IN,25473,128610,1619,154083,41,3227,346,3573
20200513,KS,7468,50160,164,57628,6,3167,352,3519
20200513,KY,6853,103781,321,110634,10,6434,176,6610
20200513,LA,32662,205242,2381,237904,34,9280,612,9892
20200513,MA,80497,329535,5315,410032,174,7371,1165,8536
20200513,MD,34812,138762,1809,173574,53,3320,751,4071
20200513,ME,1515,22092,66,23607,1,0,38,38
20200513,MI,48391,259869,4714,308260,40,0,370,370
20200513,MN,12917,109118,638,122035,24,778,423,1201
20200513,MO,10142,114000,542,124142,18,2710,136,2846
20200513,MP,19,3021,2,3040,0,167,0,167
20200513,MS,10090,89958,465,100048,8,2174,182,2356
20200513,MT,462,23390,16,23852,0,816,1,817
20200513,NC,15816,194641,597,210457,20,7743,470,8213
20200513,ND,1647,47298,40,48945,2,1037,76,1113
20200513,NE,8692,41033,103,49725,3,1662,120,1782
20200513,NH,3239,33977,142,37267,9,1576,79,1655
20200513,NJ,141560,299890,9702,441450,194,7573,817,8390
20200513,NM,5212,105077,219,110289,11,3425,143,3568
20200513,NV,6394,60278,321,66672,9,2514,83,2597
20200513,NY,340661,918246,22013,1258907,168,31618,2176,33794
20200513,OH,25721,200133,1483,225854,47,7652,471,8123
20200513,OK,4852,104275,278,109127,0,12896,120,13016
20200513,OR,3416,80571,134,83987,4,6251,130,6381
20200513,PA,58698,244171,3943,302869,137,6182,707,6889
20200513,PR,2329,,115,2329,1,0,30,30
20200513,RI,11835,86087,462,97922,18,2462,221,2683
20200513,SC,7927,85213,355,93140,0,0,0,0
20200513,SD,3732,22112,39,25844,0,578,69,647
20200513,TN,16370,276547,273,292917,8,8834,259,9093
20200513,TX,42403,545028,1158,587431,25,47904,1355,49259
20200513,UT,6620,150166,75,156786,2,3113,188,3301
20200513,VA,26746,134646,927,161877,36,5117,946,6063
20200513,VI,69,1128,6,1259,0,13,0,13
20200513,VT,929,20747,53,21676,0,412,2,414
20200513,WA,18200,259677,962,277877,17,5868,267,6135
20200513,WI,10902,117111,421,128207,3,4363,291,4654
20200513,WV,1398,65282,58,66680,1,1584,27,1611
20200513,WY,675,14384,7,15059,0,0,0,0
20200512,AK,383,29578,10,29961,0,1279,2,1281
20200512,AL,10310,122908,429,133218,28,3473,301,3774
20200512,AR,4164,66280,95,70444,1,1284,130,1414
20200512,AS,0,105,0,105,0,0,0,0
20200512,AZ,11736,111106,562,122842,20,6022,356,6378
20200512,CA,69382,963988,2847,1033370,77,40030,1443,41473
20200512,CO,19879,88778,987,108657,6,-113,-20,-133
20200512,CT,34333,104091,3041,138424,33,5348,568,5916
20200512,DC,6485,24565,336,31050,8,693,96,789
20200512,DE,6741,26550,237,33291,12,1187,176,1363
20200512,FL,41923,537681,1849,580668,44,17606,941,18547
20200512,GA,34635,227544,1461,262179,20,10183,708,10891
20200512,GU,152,3939,5,4091,0,101,1,102
20200512,HI,634,37305,17,37939,0,254,2,256
20200512,IA,12912,68376,289,81288,18,2957,539,3496
20200512,ID,2260,30445,70,32705,3,533,30,563
20200512,IL,83021,388670,3601,471691,142,25252,4014,29266
20200512,IN,25127,125383,1578,150510,38,3322,500,3822
20200512,KS,7116,46993,158,54109,0,0,0,0
20200512,KY,6677,97347,311,104024,7,16864,237,17101
20200512,LA,32050,195962,2347,228012,39,6947,235,7182
20200512,MA,79332,322164,5141,401496,33,5898,870,6768
20200512,MD,34061,135442,1756,169503,73,4035,688,4723
20200512,ME,1477,22092,65,23569,0,0,15,15
20200512,MI,48021,259869,4674,307890,90,8473,469,8942
20200512,MN,12494,108340,614,120834,23,4358,695,5053
20200512,MO,10006,111290,524,121296,36,5588,88,5676
20200512,MP,19,2854,2,2873,0,178,0,178
20200512,MS,9908,87784,457,97692,22,1573,234,1807
20200512,MT,461,22574,16,23035,0,461,2,463
20200512,NC,15346,186898,577,202244,27,6078,301,6379
20200512,ND,1571,46261,38,47832,2,765,53,818
20200512,NE,8572,39371,100,47943,2,1447,257,1704
20200512,NH,3160,32401,133,35615,0,678,0,678
20200512,NJ,140743,292317,9508,433060,198,6329,798,7127
20200512,NM,5069,101652,208,106721,8,4017,206,4223
20200512,NV,6311,57764,312,64075,6,3832,159,3991
20200512,NY,338485,886628,21845,1225113,205,19032,1430,20462
20200512,OH,25250,192481,1436,217731,79,6728,473,7201
20200512,OK,4732,91379,278,96111,4,0,119,119
20200512,OR,3286,74320,130,77606,0,0,0,0
20200512,PA,57991,237989,3806,295980,75,6285,837,7122
20200512,PR,2299,,114,2299,1,0,43,43
20200512,RI,11614,83625,444,95239,14,1743,164,1907
20200512,SC,7927,85213,355,93140,24,8409,274,8683
20200512,SD,3663,21534,39,25197,5,570,49,619
20200512,TN,16111,267713,265,283824,14,9980,567,10547
20200512,TX,41048,497124,1133,538172,33,11296,1179,12475
20200512,UT,6432,147053,73,153485,5,2830,70,2900
20200512,VA,25800,129529,891,155776,41,3982,730,4712
20200512,VI,69,1115,6,1242,1,5,0,5
20200512,VT,927,20335,53,21262,0,390,1,391
20200512,WA,17933,253809,945,271742,14,5803,236,6039
20200512,WI,10611,112748,418,123539,9,4715,193,4908
20200512,WV,1371,63698,57,65069,3,1595,5,1600
20200512,WY,675,14384,7,15059,0,2981,13,2994
20200511,AK,381,28299,10,28680,0,1314,2,1316
20200511,AL,10009,119435,401,129444,8,1791,232,2023
20200511,AR,4034,64996,94,69030,6,3215,287,3502
20200511,AS,0,105,0,105,0,22,0,22
20200511,AZ,11380,105084,542,116464,6,5826,261,6087
20200511,CA,67939,923958,2770,991897,25,34974,1259,36233
20200511,CO,19899,88891,981,108790,14,7656,524,8180
20200511,CT,33765,98743,3008,132508,41,2105,211,2316
20200511,DC,6389,23872,328,30261,5,574,117,691
20200511,DE,6565,25363,225,31928,1,771,118,889
20200511,FL,40982,520075,1805,562137,14,21723,386,22109
20200511,GA,33927,217361,1441,251288,36,7255,486,7741
20200511,GU,151,3838,5,3989,0,195,0,195
20200511,HI,632,37051,17,37683,0,412,1,413
20200511,IA,12373,65419,271,77792,6,3204,414,3618
20200511,ID,2230,29912,67,32142,0,0,0,0
20200511,IL,79007,363418,3459,442425,53,11175,1266,12441
20200511,IN,24627,122061,1540,146688,32,6158,501,6659
20200511,KS,7116,46993,158,54109,1,1436,168,1604
20200511,KY,6440,80483,304,86923,0,0,0,0
20200511,LA,31815,189015,2308,220830,22,4743,215,4958
20200511,MA,78462,316266,5108,394728,129,5670,669,6339
20200511,MD,33373,131407,1683,164780,39,4063,786,4849
20200511,ME,1462,22092,65,23554,1,0,26,26
20200511,MI,47552,251396,4584,298948,33,12856,414,13270
20200511,MN,11799,103982,591,115781,13,4165,528,4693
20200511,MO,9918,105702,488,115620,6,0,74,74
20200511,MP,19,2676,2,2695,0,355,3,358
20200511,MS,9674,86211,435,95885,5,14110,173,14283
20200511,MT,459,22113,16,22572,0,867,1,868
20200511,NC,15045,180820,550,195865,3,3449,281,3730
20200511,ND,1518,45496,36,47014,1,2118,27,2145
20200511,NE,8315,37924,98,46239,2,589,81,670
20200511,NH,3160,31723,133,35144,2,1281,149,1430
20200511,NJ,139945,285988,9310,425933,55,112073,1413,113486
20200511,NM,4863,97635,200,102498,9,5360,85,5445
20200511,NV,6152,53932,306,60084,0,1221,54,1275
20200511,NY,337055,867596,21640,1204651,162,19993,1660,21653
20200511,OH,24777,185753,1357,210530,16,4972,696,5668
20200511,OK,4613,91379,274,95992,2,0,24,24
20200511,OR,3286,74320,130,77606,3,2041,58,2099
20200511,PA,57154,231704,3731,288858,24,3932,543,4475
20200511,PR,2256,,113,2256,2,0,58,58
20200511,RI,11450,81882,430,93332,8,1943,176,2119
20200511,SC,7653,76804,331,84457,0,0,0,0
20200511,SD,3614,20964,34,24578,0,587,97,684
20200511,TN,15544,257733,251,273277,8,10849,559,11408
20200511,TX,39869,485828,1100,525697,12,22921,1000,23921
20200511,UT,6362,144223,68,150585,1,3964,111,4075
20200511,VA,25070,125547,850,151049,11,6573,989,7562
20200511,VI,69,1110,5,1215,1,8,0,8
20200511,VT,926,19945,53,20871,0,824,-1,823
20200511,WA,17697,248006,931,265703,10,5602,281,5883
20200511,WI,10418,108033,409,118631,9,2870,199,3069
20200511,WV,1366,62103,54,63469,0,819,6,825
20200511,WY,662,11403,7,12065,0,0,1,1
20200510,AK,379,26985,10,27364,0,914,1,915
20200510,AL,9777,117644,393,127421,5,1717,210,1927
20200510,AR,3747,61781,88,65528,0,0,0,0
20200510,AS,0,83,0,83,0,0,0,0
20200510,AZ,11119,99258,536,110377,4,4408,159,4567
20200510,CA,66680,888984,2745,955664,67,40975,2119,43094
20200510,CO,19375,81235,967,100610,7,3290,548,3838
20200510,CT,33554,96638,2967,130192,35,6053,570,6623
20200510,DC,6272,23298,323,29570,12,1217,170,1387
20200510,DE,6447,24592,224,31039,3,1573,170,1743
20200510,FL,40596,498352,1791,540213,6,10622,595,11217
20200510,GA,33441,210106,1405,243547,5,7314,909,8223
20200510,GU,151,3643,5,3794,0,0,0,0
20200510,HI,631,36639,17,37270,0,1006,2,1008
20200510,IA,11959,62215,265,74174,13,2410,288,2698
20200510,ID,2230,29912,67,32142,0,311,25,336
20200510,IL,77741,352243,3406,429984,57,11997,1656,13653
20200510,IN,24126,115903,1508,140029,18,3949,394,4343
20200510,KS,6948,45557,157,52505,0,2375,197,2572
20200510,KY,6440,80483,304,86923,6,324,152,476
20200510,LA,31600,184272,2286,215872,19,3532,183,3715
20200510,MA,77793,310596,4979,388389,139,10802,1050,11852
20200510,MD,32587,127344,1644,159931,30,2850,1053,3903
20200510,ME,1436,22092,64,23528,0,0,28,28
20200510,MI,47138,238540,4551,285678,25,11810,382,12192
20200510,MN,11271,99817,578,111088,20,4344,481,4825
20200510,MO,9844,105702,482,115546,10,6470,178,6648
20200510,MP,16,2321,2,2337,0,0,0,0
20200510,MS,9501,72101,430,81602,9,0,123,123
20200510,MT,458,21246,16,21704,0,375,0,375
20200510,NC,14764,177371,547,192135,3,5369,404,5773
20200510,ND,1491,43378,35,44869,0,909,27,936
20200510,NE,8234,37335,96,45569,4,2190,403,2593
20200510,NH,3011,30442,131,33965,10,1091,64,1155
20200510,NJ,138532,173915,9255,313038,139,5794,1447,7241
20200510,NM,4778,92275,191,97053,10,3686,105,3791
20200510,NV,6098,52711,306,58809,5,2628,70,2698
20200510,NY,335395,847603,21478,1182998,207,26957,2273,29230
20200510,OH,24081,180781,1341,204862,10,7808,384,8192
20200510,OK,4589,91379,272,95968,2,0,99,99
20200510,OR,3228,72279,127,75507,0,819,68,887
20200510,PA,56611,227772,3707,284383,19,5981,1295,7276
20200510,PR,2198,,111,2198,3,0,25,25
20200510,RI,11274,79939,422,91213,4,3113,285,3398
20200510,SC,7653,76804,331,84457,1,3372,122,3494
20200510,SD,3517,20377,34,23894,0,818,124,942
20200510,TN,14985,246884,243,261869,1,8904,217,9121
20200510,TX,38869,462907,1088,501776,39,11473,1009,12482
20200510,UT,6251,140259,67,146510,1,3068,148,3216
20200510,VA,24081,118974,839,143561,12,5021,885,5906
20200510,VI,69,1102,4,1210,0,78,1,79
20200510,VT,927,19121,53,20048,0,515,6,521
20200510,WA,17416,242404,921,259820,16,1225,51,1276
20200510,WI,10219,105163,400,115564,2,3228,280,3508
20200510,WV,1360,61284,54,62644,1,1622,25,1647
20200510,WY,661,11403,7,12064,0,0,17,17
20200509,AK,378,26071,10,26449,0,975,1,976
20200509,AL,9567,115927,388,125494,13,5034,346,5380
20200509,AR,3747,61781,88,65528,0,1481,53,1534
20200509,AS,0,83,0,83,0,0,0,0
20200509,AZ,10960,94850,532,105810,15,4251,434,4685
20200509,CA,64561,848009,2678,912570,93,35249,2049,37298
20200509,CO,18827,77945,960,96772,-1,2210,26,2236
20200509,CT,32984,90585,2932,123569,58,2455,573,3028
20200509,DC,6102,22081,311,28183,7,865,203,1068
20200509,DE,6277,23019,221,29296,8,866,166,1032
20200509,FL,40001,487730,1785,529183,47,13588,802,14390
20200509,GA,32532,202792,1400,235324,23,7331,426,7757
20200509,GU,151,3643,5,3794,0,17,0,17
20200509,HI,629,35633,17,36262,0,-356,0,-356
20200509,IA,11671,59805,252,71476,9,1001,214,1215
20200509,ID,2205,29601,67,31806,0,509,27,536
20200509,IL,76085,340246,3349,416331,108,14292,2325,16617
20200509,IN,23732,111954,1490,135686,43,4972,586,5558
20200509,KS,6751,43182,157,49933,5,1975,250,2225
20200509,KY,6288,80159,298,86447,4,4887,159,5046
20200509,LA,31417,180740,2267,212157,40,9179,562,9741
20200509,MA,76743,299794,4840,376537,138,9104,1410,10514
20200509,MD,31534,124494,1614,156028,54,2792,1049,3841
20200509,ME,1408,22092,64,23500,1,0,34,34
20200509,MI,46756,226730,4526,273486,133,12803,430,13233
20200509,MN,10790,95473,558,106263,24,4291,702,4993
20200509,MO,9666,99232,472,108898,23,0,177,177
20200509,MP,16,2321,2,2337,0,0,1,1
20200509,MS,9378,72101,421,81479,12,0,288,288
20200509,MT,458,20871,16,21329,0,384,0,384
20200509,NC,14360,172002,544,186362,17,7257,492,7749
20200509,ND,1464,42469,35,43933,2,1393,39,1432
20200509,NE,7831,35145,92,42976,2,1923,641,2564
20200509,NH,2947,29351,121,32602,7,1522,104,1626
20200509,NJ,137085,168121,9116,305763,164,4816,1631,6447
20200509,NM,4673,88589,181,93262,9,4050,180,4230
20200509,NV,6028,50083,301,56111,8,2623,144,2767
20200509,NY,333122,820646,21271,1153768,226,29510,2715,32225
20200509,OH,23697,172973,1331,196670,25,11673,681,12354
20200509,OK,4490,91379,270,95869,4,5946,66,6012
20200509,OR,3160,71460,127,74620,3,1835,92,1927
20200509,PA,55316,221791,3688,277107,72,5470,1078,6548
20200509,PR,2173,,108,2173,1,0,17,17
20200509,RI,10989,76826,418,87815,19,2339,210,2549
20200509,SC,7531,73432,330,80963,14,7132,389,7521
20200509,SD,3393,19559,34,22952,3,1410,249,1659
20200509,TN,14768,237980,242,252748,1,8843,327,9170
20200509,TX,37860,451434,1049,489294,45,10925,1251,12176
20200509,UT,6103,137191,66,143294,5,4422,184,4606
20200509,VA,23196,113953,827,137650,15,6350,854,7204
20200509,VI,68,1024,4,1128,0,0,0,0
20200509,VT,921,18606,53,19527,0,517,2,519
20200509,WA,17365,241179,905,258544,14,2137,119,2256
20200509,WI,9939,101935,398,112078,14,4670,349,5019
20200509,WV,1335,59662,53,60997,2,1536,25,1561
20200509,WY,644,11403,7,12047,0,0,9,9
20200508,AK,377,25096,10,25473,0,1129,3,1132
20200508,AL,9221,110893,375,120114,26,4618,323,4941
20200508,AR,3694,60300,88,63994,1,3916,83,3999
20200508,AS,0,83,0,83,0,0,0,0
20200508,AZ,10526,90599,517,101125,67,4110,581,4691
20200508,CA,62512,812760,2585,875272,81,30500,1898,32398
20200508,CO,18801,75735,961,94536,40,2218,971,3189
20200508,CT,32411,88130,2874,120541,77,3740,627,4367
20200508,DC,5899,21216,304,27115,19,1014,245,1259
20200508,DE,6111,22153,213,28264,11,766,172,938
20200508,FL,39199,474142,1738,514774,71,20020,371,20391
20200508,GA,32106,195461,1377,227567,41,9597,667,10264
20200508,GU,151,3626,5,3777,0,62,0,62
20200508,HI,629,35989,17,36618,0,1074,3,1077
20200508,IA,11457,58804,243,70261,12,3436,398,3834
20200508,ID,2178,29092,67,31270,1,360,20,380
20200508,IL,73760,325954,3241,399714,130,17784,2887,20671
20200508,IN,23146,106982,1447,130128,33,4703,643,5346
20200508,KS,6501,41207,152,47708,5,2529,357,2886
20200508,KY,6129,75272,294,81401,11,2600,195,2795
20200508,LA,30855,171561,2227,202416,19,1446,203,1649
20200508,MA,75333,290690,4702,366023,150,12779,1612,14391
20200508,MD,30485,121702,1560,152187,57,2476,1111,3587
20200508,ME,1374,22092,63,23466,1,0,44,44
20200508,MI,46326,213927,4393,260253,50,12511,680,13191
20200508,MN,10088,91182,534,101270,26,3126,723,3849
20200508,MO,9489,99232,449,108721,31,4951,148,5099
20200508,MP,15,2321,2,2336,0,538,0,538
20200508,MS,9090,72101,409,81191,13,0,404,404
20200508,MT,458,20487,16,20945,0,696,2,698
20200508,NC,13868,164745,527,178613,20,6814,471,7285
20200508,ND,1425,41076,33,42501,2,1580,54,1634
20200508,NE,7190,33222,90,40412,4,2235,419,2654
20200508,NH,2843,27829,114,31204,3,1763,103,1866
20200508,NJ,135454,163305,8952,299312,151,4282,1819,6101
20200508,NM,4493,84539,172,89032,3,3146,202,3348
20200508,NV,5884,47460,293,53344,7,1869,118,1987
20200508,NY,330407,791136,21045,1121543,217,28869,2758,31627
20200508,OH,23016,161300,1306,184316,35,7372,885,8257
20200508,OK,4424,85433,266,89857,6,2876,94,2970
20200508,OR,3068,69625,124,72693,3,2156,79,2235
20200508,PA,54238,216321,3616,270559,200,6448,1323,7771
20200508,PR,2156,,107,2156,5,0,125,125
20200508,RI,10779,74487,399,85266,11,2699,249,2948
20200508,SC,7142,66300,316,73442,11,-4246,206,-4040
20200508,SD,3144,18149,31,21293,0,940,239,1179
20200508,TN,14441,229137,241,243578,4,6905,345,7250
20200508,TX,36609,440509,1004,477118,31,20737,1219,21956
20200508,UT,5919,132769,61,138688,0,3950,195,4145
20200508,VA,22342,107603,812,130494,43,6021,772,6793
20200508,VI,68,1024,4,1128,0,34,2,36
20200508,VT,919,18089,53,19008,0,554,3,557
20200508,WA,17246,239042,891,256288,21,5773,243,6016
20200508,WI,9590,97265,384,107059,10,4230,375,4605
20200508,WV,1310,58126,51,59436,0,1892,23,1915
20200508,WY,635,11403,7,12038,0,0,4,4
20200507,AK,374,23967,10,24341,0,684,2,686
20200507,AL,8898,106275,349,115173,9,5340,317,5657
20200507,AR,3611,56384,87,59995,2,949,43,992
20200507,AS,0,83,0,83,0,0,0,0
20200507,AZ,9945,86489,450,96434,24,4459,238,4697
20200507,CA,60614,782260,2504,842874,92,32039,1799,33838
20200507,CO,17830,73517,921,91347,18,4905,466,5371
20200507,CT,31784,84390,2797,116174,79,3938,789,4727
20200507,DC,5654,20202,285,25856,8,679,193,872
20200507,DE,5939,21387,202,27326,9,697,161,858
20200507,FL,38828,454122,1667,494449,62,12073,826,12899
20200507,GA,31439,185864,1336,217303,25,12423,743,13166
20200507,GU,151,3564,5,3715,0,88,0,88
20200507,HI,626,34915,17,35541,0,341,1,342
20200507,IA,11059,55368,231,66427,12,2601,655,3256
20200507,ID,2158,28732,66,30890,1,314,31,345
20200507,IL,70873,308170,3111,379043,137,15142,2641,17783
20200507,IN,22503,102279,1414,124782,37,3653,633,4286
20200507,KS,6144,38678,147,44822,3,2298,410,2708
20200507,KY,5934,72672,283,78606,8,17480,112,17592
20200507,LA,30652,170115,2208,200767,93,5842,253,6095
20200507,MA,73721,277911,4552,351632,132,10297,1696,11993
20200507,MD,29374,119226,1503,148600,66,3377,1211,4588
20200507,ME,1330,22092,62,23422,0,0,76,76
20200507,MI,45646,201416,4343,247062,93,13239,592,13831
20200507,MN,9365,88056,508,97421,23,3403,786,4189
20200507,MO,9341,94281,418,103622,22,2636,239,2875
20200507,MP,15,1783,2,1798,0,0,0,0
20200507,MS,8686,72101,396,80787,22,0,262,262
20200507,MT,456,19791,16,20247,0,543,0,543
20200507,NC,13397,157931,507,171328,30,6207,639,6846
20200507,ND,1371,39496,31,40867,0,2187,48,2235
20200507,NE,6771,30987,86,37758,4,1297,333,1630
20200507,NH,2740,26066,111,29151,19,969,104,1073
20200507,NJ,133635,159023,8801,293210,252,1993,1745,3738
20200507,NM,4291,81393,169,85684,7,2280,153,2433
20200507,NV,5766,45591,286,51357,10,1979,103,2082
20200507,NY,327649,762267,20828,1089916,951,30324,3671,33995
20200507,OH,22131,153928,1271,176059,46,6575,555,7130
20200507,OK,4330,82557,260,86887,7,3868,129,3997
20200507,OR,2989,67469,121,70458,6,2409,73,2482
20200507,PA,52915,209873,3416,262788,310,5378,1070,6448
20200507,PR,2031,,102,2031,3,0,63,63
20200507,RI,10530,71788,388,82318,18,2620,325,2945
20200507,SC,6936,70546,305,77482,0,0,0,0
20200507,SD,2905,17209,31,20114,2,572,126,698
20200507,TN,14096,222232,237,236328,-2,9069,158,9227
20200507,TX,35390,419772,973,455162,25,15256,968,16224
20200507,UT,5724,128819,61,134543,3,3412,129,3541
20200507,VA,21570,101582,769,123671,56,8130,1314,9444
20200507,VI,66,990,4,1093,0,0,0,0
20200507,VT,916,17535,53,18451,1,567,8,575
20200507,WA,17003,233269,870,250272,8,5518,243,5761
20200507,WI,9215,93035,374,102469,12,5209,314,5523
20200507,WV,1287,56234,51,57521,1,1698,39,1737
20200507,WY,631,11403,7,12034,0,0,27,27
20200506,AK,372,23283,10,23655,1,962,1,963
20200506,AL,8581,100935,340,109516,27,2454,296,2750
20200506,AR,3568,55435,85,59003,5,4296,72,4368
20200506,AS,0,83,0,83,0,0,0,0
20200506,AZ,9707,82030,426,91737,31,3075,402,3477
20200506,CA,58815,750221,2412,809036,95,26531,2603,29134
20200506,CO,17364,68612,903,85976,52,515,457,972
20200506,CT,30995,80452,2718,111447,85,2430,374,2804
20200506,DC,5461,19523,277,24984,13,516,139,655
20200506,DE,5778,20690,193,26468,6,1381,407,1788
20200506,FL,38002,442049,1605,481402,69,13797,563,14360
20200506,GA,30696,173441,1311,204137,23,2269,985,3254
20200506,GU,151,3476,5,3627,0,135,2,137
20200506,HI,625,34574,17,35199,0,1196,4,1200
20200506,IA,10404,52767,219,63171,12,2309,293,2602
20200506,ID,2127,28418,65,30545,1,216,21,237
20200506,IL,68232,293028,2974,361260,136,12704,2270,14974
20200506,IN,21870,98626,1377,120496,51,3825,837,4662
20200506,KS,5734,36380,144,42114,7,1746,276,2022
20200506,KY,5822,55192,275,61014,14,390,577,967
20200506,LA,30399,164273,2115,194672,0,6038,403,6441
20200506,MA,72025,267614,4420,339639,208,4536,1754,6290
20200506,MD,28163,115849,1437,144012,47,2863,1046,3909
20200506,ME,1254,22092,62,23346,1,2546,28,2574
20200506,MI,45054,188177,4250,233231,71,9738,657,10395
20200506,MN,8579,84653,485,93232,30,4495,728,5223
20200506,MO,9102,91645,396,100747,19,5495,186,5681
20200506,MP,15,1783,2,1798,0,0,1,1
20200506,MS,8424,72101,374,80525,32,0,217,217
20200506,MT,456,19248,16,19704,0,4432,0,4432
20200506,NC,12758,151724,477,164482,25,12180,502,12682
20200506,ND,1323,37309,31,38632,6,2154,57,2211
20200506,NE,6438,29690,82,36128,4,1164,355,1519
20200506,NH,2636,25097,92,27812,6,815,48,863
20200506,NJ,131890,157030,8549,289514,305,0,1297,1297
20200506,NM,4138,79113,162,83251,6,1424,107,1531
20200506,NV,5663,43612,276,49275,8,1322,69,1391
20200506,NY,323978,731943,19877,1055921,232,24236,2786,27022
20200506,OH,21576,147353,1225,168929,90,7587,607,8194
20200506,OK,4201,78689,253,82890,6,3399,74,3473
20200506,OR,2916,65060,115,67976,2,2475,77,2552
20200506,PA,51845,204495,3106,256340,94,4570,888,5458
20200506,PR,1968,,99,1968,0,0,44,-9269
20200506,RI,10205,69168,370,79373,15,2666,272,2938
20200506,SC,6936,70546,305,77482,22,9532,179,9711
20200506,SD,2779,16637,29,19416,5,336,58,394
20200506,TN,13938,213163,239,227101,13,7991,248,8239
20200506,TX,34422,404516,948,438938,42,10675,1053,11728
20200506,UT,5595,125407,58,131002,2,4141,146,4287
20200506,VA,20256,93452,713,114177,0,0,0,0
20200506,VI,66,990,4,1093,0,17,0,17
20200506,VT,908,16968,52,17876,0,357,1,358
20200506,WA,16760,227751,862,244511,21,6666,273,6939
20200506,WI,8901,87826,362,96939,9,3859,335,4194
20200506,WV,1248,54536,50,55784,0,951,10,961
20200506,WY,604,11403,7,12007,0,1084,8,1092
20200505,AK,371,22321,9,22692,0,968,1,969
20200505,AL,8285,98481,313,106766,17,3389,260,3649
20200505,AR,3496,51139,80,54635,-1,155,38,193
20200505,AS,0,83,0,83,0,0,0,0
20200505,AZ,9305,78955,395,88260,33,2621,386,3007
20200505,CA,56212,723690,2317,779902,63,30753,1275,32028
20200505,CO,16907,68097,851,85004,9,1642,272,1914
20200505,CT,30621,78022,2633,108643,138,4816,1334,6150
20200505,DC,5322,19007,264,24329,6,382,152,534
20200505,DE,5371,19309,187,24680,5,487,83,570
20200505,FL,37439,428252,1536,466956,113,20879,542,21421
20200505,GA,29711,171172,1288,200883,66,17215,343,17558
20200505,GU,149,3341,5,3490,0,99,0,99
20200505,HI,621,33378,17,33999,0,132,1,133
20200505,IA,10111,50458,207,60569,19,3000,408,3408
20200505,ID,2106,28202,64,30308,0,456,45,501
20200505,IL,65962,280324,2838,346286,176,11017,2122,13139
20200505,IN,21033,94801,1326,115834,62,2011,526,2537
20200505,KS,5458,34634,137,40092,1,1276,213,1489
20200505,KY,5245,54802,261,60047,8,1523,115,1638
20200505,LA,29996,158235,2115,188231,51,6977,323,7300
20200505,MA,70271,263078,4212,333349,122,7897,1184,9081
20200505,MD,27117,112986,1390,140103,73,2399,709,3108
20200505,ME,1226,19546,61,20772,4,0,21,21
20200505,MI,44397,178439,4179,222836,130,0,447,447
20200505,MN,7851,80158,455,88009,27,1451,617,2068
20200505,MO,8916,86150,377,95066,19,3453,162,3615
20200505,MP,14,1783,2,1797,0,462,0,462
20200505,MS,8207,72101,342,80308,32,301,330,631
20200505,MT,456,14816,16,15272,0,185,-1,184
20200505,NC,12256,139544,452,151800,22,4953,408,5361
20200505,ND,1266,35155,25,36421,0,1626,41,1667
20200505,NE,6083,28526,78,34609,0,682,173,855
20200505,NH,2588,24282,86,26949,0,0,0,0
20200505,NJ,130593,157030,8244,288173,334,8079,2324,10403
20200505,NM,4031,77689,156,81720,5,3562,181,3743
20200505,NV,5594,42290,268,47884,6,1615,103,1718
20200505,NY,321192,707707,19645,1028899,230,19350,2239,21589
20200505,OH,20969,139766,1135,160735,79,5085,495,5580
20200505,OK,4127,75290,247,79417,9,15486,83,15569
20200505,OR,2839,62585,113,65424,4,1887,80,1967
20200505,PA,50957,199925,3012,250882,554,4427,865,5292
20200505,PR,1924,9313,99,11237,2,0,81,81
20200505,RI,9933,66502,355,76435,14,2018,281,2299
20200505,SC,6757,61014,283,67771,8,3452,131,3583
20200505,SD,2721,16301,24,19022,3,256,53,309
20200505,TN,13690,205172,226,218862,7,7300,119,7419
20200505,TX,33369,393841,906,427210,22,18775,1037,19812
20200505,UT,5449,121266,56,126715,6,1922,132,2054
20200505,VA,20256,93452,713,114177,29,651,764,1415
20200505,VI,66,973,4,1073,0,8,0,8
20200505,VT,907,16611,52,17518,0,181,5,186
20200505,WA,16487,221085,841,237572,7,5942,247,6189
20200505,WI,8566,83967,353,92769,13,3500,330,3830
20200505,WV,1238,53585,50,54823,0,1552,32,1584
20200505,WY,596,10319,7,10915,0,451,10,461
20200504,AK,370,21353,9,21723,0,143,2,145
20200504,AL,8025,95092,296,103117,6,10317,300,10617
20200504,AR,3458,50984,81,54442,5,1525,27,1552
20200504,AS,0,83,0,83,0,26,0,26
20200504,AZ,8919,76334,362,85253,0,3855,279,4134
20200504,CA,54937,692937,2254,747874,39,30802,1321,32123
20200504,CO,16635,66455,842,83090,10,2774,410,3184
20200504,CT,29287,73206,2495,102493,59,0,0,0
20200504,DC,5170,18625,258,23795,7,539,154,693
20200504,DE,5288,18822,182,24110,5,293,80,373
20200504,FL,36897,407373,1423,445451,20,15262,819,16081
20200504,GA,29368,153957,1222,183325,45,7463,766,8229
20200504,GU,149,3242,5,3391,0,90,-1,89
20200504,HI,620,33246,17,33866,1,916,0,916
20200504,IA,9703,47458,188,57161,4,3441,534,3975
20200504,ID,2061,27746,64,29807,1,0,0,0
20200504,IL,63840,269307,2662,333147,44,11493,2341,13834
20200504,IN,20507,92790,1264,113297,18,3864,574,4438
20200504,KS,5245,33358,136,38603,2,1610,215,1825
20200504,KY,5130,53279,253,58409,5,509,251,760
20200504,LA,29673,151258,2064,180931,95,4438,333,4771
20200504,MA,69087,255181,4090,324268,86,8622,1000,9622
20200504,MD,26408,110587,1317,136995,36,3255,946,4201
20200504,ME,1205,19546,57,20751,0,0,20,20
20200504,MI,43950,178439,4049,222389,0,9661,196,9857
20200504,MN,7234,78707,428,85941,9,2738,571,3309
20200504,MO,8754,82697,358,91451,6,8107,368,8475
20200504,MP,14,1321,2,1335,0,0,0,0
20200504,MS,7877,71800,310,79677,7,1757,327,2084
20200504,MT,457,14631,16,15088,0,79,2,81
20200504,NC,11848,134591,430,146439,8,2420,184,2604
20200504,ND,1225,33529,25,34754,0,1367,34,1401
20200504,NE,5910,27844,78,33754,2,1908,584,2492
20200504,NH,2588,24282,86,27114,2,-1682,159,-1523
20200504,NJ,128269,148951,7910,277867,39,629,1525,2154
20200504,NM,3850,74127,151,77977,12,2915,118,3033
20200504,NV,5491,40675,262,46166,5,832,65,897
20200504,NY,318953,688357,19415,1007310,226,18861,2538,21399
20200504,OH,20474,134681,1056,155155,18,4429,560,4989
20200504,OK,4044,59804,238,63848,0,0,72,72
20200504,OR,2759,60698,109,63457,0,1324,79,1403
20200504,PA,50092,195498,2458,245590,14,4124,825,4949
20200504,PR,1843,9313,97,11156,0,0,35,35
20200504,RI,9652,64484,341,74136,21,2034,175,2209
20200504,SC,6626,57562,275,64188,0,0,0,0
20200504,SD,2668,16045,21,18713,0,259,37,296
20200504,TN,13571,197872,219,211443,9,6442,394,6836
20200504,TX,32332,375066,884,407398,17,16054,784,16838
20200504,UT,5317,119344,50,124661,0,2417,142,2559
20200504,VA,19492,92801,684,112771,24,3470,821,4291
20200504,VI,66,965,4,1046,0,14,0,14
20200504,VT,902,16430,52,17332,0,373,5,378
20200504,WA,16240,215143,834,231383,4,6185,371,6556
20200504,WI,8236,80467,340,88929,1,2470,272,2742
20200504,WV,1206,52033,50,53239,0,1586,15,1601
20200504,WY,586,9868,7,10454,0,228,7,235
20200503,AK,368,21210,9,21578,0,176,3,179
20200503,AL,7725,84775,290,92500,2,0,291,291
20200503,AR,3431,49459,76,52890,3,1249,59,1308
20200503,AS,0,57,0,57,0,0,0,0
20200503,AZ,8640,72479,362,81119,14,2846,276,3122
20200503,CA,53616,662135,2215,715751,44,27529,1419,28948
20200503,CO,16225,63681,832,79906,12,2500,457,2957
20200503,CT,29287,73206,2436,102493,97,1713,523,2236
20200503,DC,5016,18086,251,23102,11,879,219,1098
20200503,DE,5208,18529,177,23737,9,455,170,625
20200503,FL,36078,392111,1403,429415,15,11562,615,12177
20200503,GA,28602,146494,1177,175096,3,0,296,296
20200503,GU,150,3152,5,3302,0,112,2,114
20200503,HI,620,32330,16,32950,0,964,1,965
20200503,IA,9169,44017,184,53186,9,6309,528,6837
20200503,ID,2061,27746,63,29807,0,291,26,317
20200503,IL,61499,257814,2618,319313,59,16423,2994,19417
20200503,IN,19933,88926,1246,108859,17,4080,638,4718
20200503,KS,5030,31748,134,36778,3,1552,284,1836
20200503,KY,4879,52770,248,57649,0,0,0,0
20200503,LA,29340,146820,1969,176160,19,3102,200,3302
20200503,MA,68087,246559,4004,314646,158,13828,1824,15652
20200503,MD,25462,107332,1281,132794,30,6283,989,7272
20200503,ME,1185,19546,57,20731,1,0,33,33
20200503,MI,43754,168778,4049,212532,29,10276,547,10823
20200503,MN,6663,75969,419,82632,24,3190,435,3625
20200503,MO,8386,74590,352,82976,1,0,232,232
20200503,MP,14,1321,2,1335,0,387,0,387
20200503,MS,7550,70043,303,77593,12,3009,109,3118
20200503,MT,455,14552,16,15007,0,372,0,372
20200503,NC,11664,132171,422,143835,2,4205,155,4360
20200503,ND,1191,32162,25,33353,1,1768,38,1806
20200503,NE,5326,25936,76,31262,3,1426,488,1914
20200503,NH,2429,25964,84,28613,3,3925,119,4044
20200503,NJ,126744,148322,7871,275707,129,9727,3027,12754
20200503,NM,3732,71212,139,74944,8,3607,219,3826
20200503,NV,5426,39843,257,45269,3,767,115,882
20200503,NY,316415,669496,19189,985911,280,23402,3438,26840
20200503,OH,19914,130252,1038,150166,17,3768,579,4347
20200503,OK,3972,59804,238,63776,0,0,121,121
20200503,OR,2680,59374,109,62054,0,1873,45,1918
20200503,PA,49267,191374,2444,240641,26,4303,962,5265
20200503,PR,1808,9313,97,11121,2,0,51,51
20200503,RI,9477,62450,320,71927,24,1811,188,1999
20200503,SC,6626,57562,275,64188,8,2435,137,2572
20200503,SD,2631,15786,21,18417,0,283,43,326
20200503,TN,13177,191430,210,204607,1,7815,516,8331
20200503,TX,31548,359012,867,390560,20,8886,1026,9912
20200503,UT,5175,116927,50,122102,1,4104,194,4298
20200503,VA,18671,89331,660,108467,44,4966,940,5906
20200503,VI,66,951,4,1046,0,29,0,29
20200503,VT,897,16057,52,16954,1,352,11,363
20200503,WA,15869,208958,830,224827,6,1292,78,1370
20200503,WI,7964,77997,339,86192,5,2427,304,2731
20200503,WV,1191,50447,50,51638,2,2470,22,2492
20200503,WY,579,9640,7,10219,0,177,13,190
20200502,AK,365,21034,9,21399,0,1073,1,1074
20200502,AL,7434,84775,288,92209,9,0,276,276
20200502,AR,3372,48210,73,51582,9,1855,51,1906
20200502,AS,0,57,0,57,0,0,0,0
20200502,AZ,8364,69633,348,77997,18,2716,402,3118
20200502,CA,52197,634606,2171,686803,98,30063,1755,31818
20200502,CO,15768,61181,820,76949,43,4075,484,4559
20200502,CT,28764,71493,2339,100257,0,0,0,0
20200502,DC,4797,17207,240,22004,9,730,139,869
20200502,DE,5038,18074,168,23112,9,407,120,527
20200502,FL,35463,380549,1388,416012,74,12578,735,13313
20200502,GA,28306,146494,1174,174800,20,5397,1036,6433
20200502,GU,148,3040,5,3188,0,181,2,183
20200502,HI,619,31366,16,31985,0,890,1,891
20200502,IA,8641,37708,175,46349,5,0,757,757
20200502,ID,2035,27455,63,29490,0,245,20,265
20200502,IL,58505,241391,2559,299896,102,12758,2450,15208
20200502,IN,19295,84846,1229,104141,54,3837,665,4502
20200502,KS,4746,30196,131,34942,1,1611,297,1908
20200502,KY,4879,52770,248,57649,8,866,171,1037
20200502,LA,29140,143718,1950,172858,23,4178,429,4607
20200502,MA,66263,232731,3846,298994,130,7406,1952,9358
20200502,MD,24473,101049,1251,125522,59,3538,1001,4539
20200502,ME,1152,19546,56,20698,1,0,29,29
20200502,MI,43207,158502,4020,201709,154,10353,851,11204
20200502,MN,6228,72779,395,79007,24,3680,498,4178
20200502,MO,8154,74590,351,82744,14,0,319,319
20200502,MP,14,934,2,948,0,185,0,185
20200502,MS,7441,67034,291,74475,10,2698,229,2927
20200502,MT,455,14180,16,14635,0,430,2,432
20200502,NC,11509,127966,420,139475,21,5057,586,5643
20200502,ND,1153,30394,24,31547,1,1976,46,2022
20200502,NE,4838,24510,73,29348,3,1406,557,1963
20200502,NH,2310,22039,81,24508,9,2136,164,2300
20200502,NJ,123717,138595,7742,262988,204,3240,2527,5767
20200502,NM,3513,67605,131,71118,8,3147,102,3249
20200502,NV,5311,39076,254,44387,11,708,84,792
20200502,NY,312977,646094,18909,959071,299,26970,4663,31633
20200502,OH,19335,126484,1021,145819,19,4721,592,5313
20200502,OK,3851,59804,238,63655,8,0,103,103
20200502,OR,2635,57501,109,60136,5,1904,56,1960
20200502,PA,48305,187071,2418,235376,64,6594,1334,7928
20200502,PR,1757,9313,95,11070,3,0,182,182
20200502,RI,9289,60639,296,69928,17,2953,327,3280
20200502,SC,6489,55127,267,61616,11,2006,231,2237
20200502,SD,2588,15503,21,18091,0,665,63,728
20200502,TN,12661,183615,209,196276,5,9374,770,10144
20200502,TX,30522,350126,847,380648,31,27580,1293,28873
20200502,UT,4981,112823,49,117804,3,5093,153,5246
20200502,VA,17731,84365,616,102554,35,-5174,830,-4344
20200502,VI,66,922,4,1042,0,111,0,111
20200502,VT,886,15705,51,16591,1,351,7,358
20200502,WA,15791,207666,824,223457,10,2448,109,2557
20200502,WI,7660,75570,334,83461,7,3004,346,3350
20200502,WV,1169,47977,48,49146,2,2269,33,2302
20200502,WY,566,9463,7,10029,0,327,7,334
20200501,AK,364,19961,9,20325,0,1197,9,1206
20200501,AL,7158,84775,279,91933,10,4598,139,4737
20200501,AR,3321,46355,64,49676,3,1231,66,1297
20200501,AS,0,57,0,57,0,54,0,54
20200501,AZ,7962,66917,330,74879,10,2779,314,3093
20200501,CA,50442,604543,2073,654985,91,28123,1525,29648
20200501,CO,15284,57106,777,72390,11,805,526,1331
20200501,CT,28764,71493,2339,100257,82,2060,1064,3124
20200501,DC,4658,16477,231,21135,7,721,335,1056
20200501,DE,4918,17667,159,22585,7,581,184,765
20200501,FL,34728,367971,1314,402699,24,19256,1038,20294
20200501,GA,27270,141097,1154,168367,34,18208,1115,19323
20200501,GU,146,2859,5,3005,0,897,0,897
20200501,HI,618,30476,16,31094,0,449,5,454
20200501,IA,7884,37708,170,45592,8,2186,739,2925
20200501,ID,2015,27210,63,29225,3,501,31,532
20200501,IL,56055,228633,2457,284688,102,11684,3137,14821
20200501,IN,18630,81009,1175,99639,61,3846,795,4641
20200501,KS,4449,28585,130,33034,1,1197,211,1408
20200501,KY,4708,51904,240,56612,5,2342,169,2511
20200501,LA,28711,139540,1927,168251,65,6232,710,6942
20200501,MA,64311,225325,3716,289636,154,11883,2106,13989
20200501,MD,23472,97511,1192,120983,52,4894,1730,6624
20200501,ME,1123,19546,55,20669,2,0,28,28
20200501,MI,42356,148149,3866,190505,77,9261,977,10238
20200501,MN,5730,69099,371,74829,28,3959,594,4553
20200501,MO,7835,74590,337,82425,8,1465,273,1738
20200501,MP,14,749,2,763,0,164,0,164
20200501,MS,7212,64336,281,71548,20,4811,397,5208
20200501,MT,453,13750,16,14203,0,289,0,289
20200501,NC,10923,122909,399,133832,21,5382,414,5796
20200501,ND,1107,28418,23,29525,4,2025,40,2065
20200501,NE,4281,23104,70,27385,2,1567,497,2064
20200501,NH,2146,19903,72,22351,6,36,92,128
20200501,NJ,121190,135355,7538,257128,310,6089,2538,8627
20200501,NM,3411,64458,123,67869,11,2586,198,2784
20200501,NV,5227,38368,243,43595,6,1380,229,1609
20200501,NY,308314,619124,18610,927438,289,22860,3942,26802
20200501,OH,18743,121763,1002,140506,27,5900,716,6616
20200501,OK,3748,59804,230,63552,8,0,130,130
20200501,OR,2579,55597,104,58176,1,2075,69,2144
20200501,PA,46971,180477,2354,227448,62,4875,1208,6083
20200501,PR,1575,9313,92,10888,0,0,36,36
20200501,RI,8962,57686,279,66648,13,2597,341,2938
20200501,SC,6258,53121,256,59379,12,2704,163,2867
20200501,SD,2525,14838,21,17363,4,259,76,335
20200501,TN,11891,174241,204,186132,5,7350,1156,8506
20200501,TX,29229,322546,816,351775,34,20333,1142,21475
20200501,UT,4828,107730,46,112558,0,3901,156,4057
20200501,VA,16901,89539,581,106908,29,13876,1055,14931
20200501,VI,66,811,4,945,0,4,0,4
20200501,VT,879,15354,50,16233,1,568,13,581
20200501,WA,15682,205218,814,220900,13,6080,306,6386
20200501,WI,7314,72566,327,80098,11,3172,460,3632
20200501,WV,1136,45708,46,46844,5,2285,18,2303
20200501,WY,559,9136,7,9695,0,234,15,249
20200430,AK,355,18764,9,19119,0,0,0,0
20200430,AL,7019,80177,269,87196,24,6570,177,6747
20200430,AR,3255,45124,61,48379,2,2867,63,2930
20200430,AS,0,3,0,20,0,0,0,0
20200430,AZ,7648,64138,320,71786,16,2527,446,2973
20200430,CA,48917,576420,1982,625337,95,19781,2417,22198
20200430,CO,14758,56301,766,71059,6,1587,23,1610
20200430,CT,27700,69433,2257,97133,89,1382,933,2315
20200430,DC,4323,15756,224,20079,19,633,217,850
20200430,DE,4734,17086,152,21820,8,203,79,282
20200430,FL,33690,348715,1290,383592,50,8420,497,8917
20200430,GA,26155,122889,1120,149044,27,4522,583,5105
20200430,GU,146,1962,5,2108,0,260,1,261
20200430,HI,613,30027,16,30640,0,1018,4,1022
20200430,IA,7145,35522,162,42667,14,1028,302,1330
20200430,ID,1984,26709,60,28693,0,279,32,311
20200430,IL,52918,216949,2355,269867,140,10637,2563,13200
20200430,IN,17835,77163,1114,94998,49,2795,653,3448
20200430,KS,4238,27388,129,31626,4,1668,500,2168
20200430,KY,4539,49562,235,54101,10,1526,164,1690
20200430,LA,28001,133308,1862,161309,60,4400,341,4741
20200430,MA,62205,213442,3562,275647,157,8089,1940,10029
20200430,MD,21742,92617,1140,114359,62,2537,893,3430
20200430,ME,1095,19546,53,20641,1,0,39,39
20200430,MI,41379,138888,3789,180267,119,6935,980,7915
20200430,MN,5136,65140,343,70276,24,3040,492,3532
20200430,MO,7562,73125,329,80687,11,3391,137,3528
20200430,MP,14,585,2,599,0,375,0,375
20200430,MS,6815,59525,261,66340,11,0,246,246
20200430,MT,453,13461,16,13914,0,384,2,386
20200430,NC,10509,117527,378,128036,24,9035,561,9596
20200430,ND,1067,26393,19,27460,0,1890,34,1924
20200430,NE,3784,21537,68,25321,13,1280,410,1690
20200430,NH,2054,19867,66,22193,6,1131,44,1175
20200430,NJ,118652,129266,7228,248396,458,4212,2388,6600
20200430,NM,3213,61872,112,65085,2,3101,239,3340
20200430,NV,4998,36988,237,41986,7,858,100,958
20200430,NY,304372,596264,18321,900636,306,23474,4681,28155
20200430,OH,18027,115863,975,133890,38,4258,724,4982
20200430,OK,3618,59804,222,63422,8,2010,145,2155
20200430,OR,2510,53522,103,56032,2,1496,64,1560
20200430,PA,45763,175602,2292,221365,97,5085,1397,6482
20200430,PR,1539,9313,92,10852,6,0,106,106
20200430,RI,8621,55089,266,63710,15,3171,374,3545
20200430,SC,6095,50417,244,56512,41,2081,214,2295
20200430,SD,2449,14579,17,17028,4,119,76,195
20200430,TN,10735,166891,199,177626,4,8708,369,9077
20200430,TX,28087,302213,782,330300,50,14477,1033,15510
20200430,UT,4672,103829,46,108501,1,2546,177,2723
20200430,VA,15846,75663,552,92092,30,4684,885,5569
20200430,VI,66,807,4,916,0,75,4,79
20200430,VT,866,14786,49,15652,2,219,4,223
20200430,WA,15376,199138,801,214514,15,5917,238,6155
20200430,WI,6854,69394,316,76443,8,2764,334,3098
20200430,WV,1118,43423,41,44541,3,1447,23,1470
20200430,WY,544,8902,7,9446,0,221,8,229
20200429,AK,355,18764,9,19119,0,2026,4,2030
20200429,AL,6842,73607,245,80449,3,4467,155,4622
20200429,AR,3192,42257,59,45449,7,4697,81,4778
20200429,AS,0,3,0,20,0,0,0,0
20200429,AZ,7202,61611,304,68813,11,1121,254,1375
20200429,CA,46500,556639,1887,603139,78,24062,1469,25531
20200429,CO,14735,54714,760,69449,54,2252,856,3108
20200429,CT,26767,68051,2168,94818,79,1618,455,2073
20200429,DC,4106,15123,205,19229,15,232,112,344
20200429,DE,4655,16883,144,21538,7,278,80,358
20200429,FL,33193,340295,1240,374740,86,6266,347,6613
20200429,GA,25572,118367,1093,143939,67,2962,957,3919
20200429,GU,145,1702,5,1847,0,164,0,164
20200429,HI,609,29009,16,29618,0,433,2,435
20200429,IA,6843,34494,148,41337,12,1047,467,1514
20200429,ID,1952,26430,60,28382,2,8295,35,8330
20200429,IL,50355,206312,2215,256667,90,12225,2253,14478
20200429,IN,17182,74368,1065,91550,164,3775,594,4369
20200429,KS,3738,25720,125,29458,1,1121,247,1368
20200429,KY,4375,48036,225,52411,12,3383,229,3612
20200429,LA,27660,128908,1802,156568,44,5086,374,5460
20200429,MA,60265,205353,3405,265618,252,9155,1963,11118
20200429,MD,20849,90080,1078,110929,62,2408,736,3144
20200429,ME,1056,19546,52,20602,1,2762,16,2778
20200429,MI,40399,131953,3670,172352,103,6410,1137,7547
20200429,MN,4644,62100,319,66744,18,2452,463,2915
20200429,MO,7425,69734,318,77159,4,3534,122,3656
20200429,MP,14,210,2,224,0,159,0,159
20200429,MS,6569,59525,250,66094,11,1455,227,1682
20200429,MT,451,13077,16,13528,1,337,0,337
20200429,NC,9948,108492,354,118440,12,5308,380,5688
20200429,ND,1033,24503,19,25536,0,1771,42,1813
20200429,NE,3374,20257,55,23631,0,10,16,26
20200429,NH,2010,18736,60,20827,0,529,72,601
20200429,NJ,116264,125054,6770,241935,328,4551,2408,6959
20200429,NM,2974,58771,110,61745,6,2791,151,2942
20200429,NV,4898,36130,230,41028,11,816,93,909
20200429,NY,299691,572790,18015,872481,377,22902,4585,27487
20200429,OH,17303,111605,937,128908,138,5027,1175,6202
20200429,OK,3473,57794,214,61267,7,1505,63,1568
20200429,OR,2446,52026,101,54472,9,3182,92,3274
20200429,PA,44366,170517,2195,214883,479,4693,1102,5795
20200429,PR,1433,9313,86,12686,0,0,33,33
20200429,RI,8247,51918,251,60165,12,2151,321,2472
20200429,SC,5881,48336,203,54217,26,1804,268,2072
20200429,SD,2373,14460,13,16833,2,161,60,221
20200429,TN,10366,158183,195,168549,7,6307,314,6621
20200429,TX,27054,287736,732,314790,42,13523,883,14406
20200429,UT,4495,101283,45,105778,0,3187,152,3339
20200429,VA,14961,70979,522,86560,30,2020,622,2642
20200429,VI,62,732,4,872,0,13,3,16
20200429,VT,862,14567,47,15429,0,214,0,214
20200429,WA,15138,193221,786,208359,21,6249,314,6563
20200429,WI,6520,66630,308,73377,8,3095,231,3326
20200429,WV,1095,41976,38,43071,1,0,16,16
20200429,WY,536,8681,7,9217,0,455,147,602
20200428,AK,351,16738,9,17089,0,827,6,833
20200428,AL,6687,69140,242,75827,20,1642,188,1830
20200428,AR,3111,37560,52,40671,2,120,94,214
20200428,AS,0,3,0,20,0,0,0,0
20200428,AZ,6948,60490,293,67438,18,663,232,895
20200428,CA,45031,532577,1809,577608,54,22632,1567,24199
20200428,CO,13879,52462,706,66341,26,2629,438,3067
20200428,CT,26312,66433,2089,92745,91,11891,1043,12934
20200428,DC,3994,14891,190,18885,5,367,102,469
20200428,DE,4575,16605,137,21180,12,1151,413,1564
20200428,FL,32846,334029,1154,368091,53,9704,708,10412
20200428,GA,24615,115405,1026,140020,55,12149,702,12851
20200428,GU,145,1538,5,1683,0,114,1,115
20200428,HI,607,28576,16,29183,2,172,1,173
20200428,IA,6376,33447,136,39823,9,1165,508,1673
20200428,ID,1917,18135,58,20052,2,137,20,157
20200428,IL,48102,194087,2125,242189,142,12342,2219,14561
20200428,IN,16588,70593,901,87181,57,2078,627,2705
20200428,KS,3491,24599,124,28090,4,760,163,923
20200428,KY,4146,44653,213,48799,5,253,72,325
20200428,LA,27286,123822,1758,151108,61,3901,218,4119
20200428,MA,58302,196198,3153,254500,150,7773,1840,9613
20200428,MD,20113,87672,1016,107785,71,2183,626,2809
20200428,ME,1040,16784,51,17824,0,0,17,17
20200428,MI,39262,125543,3567,164805,160,5993,1052,7045
20200428,MN,4181,59648,301,63829,15,2196,365,2561
20200428,MO,7303,66200,314,73503,26,2265,132,2397
20200428,MP,14,51,2,65,0,0,0,0
20200428,MS,6342,58070,239,64412,10,702,248,950
20200428,MT,451,12740,15,13191,1,156,2,158
20200428,NC,9568,103184,342,112752,36,2406,426,2832
20200428,ND,991,22732,19,23723,0,1240,49,1289
20200428,NE,3358,20247,55,23605,-1,912,330,1242
20200428,NH,1938,18207,60,20368,0,347,74,421
20200428,NJ,113856,120503,6442,234359,398,3916,2668,6584
20200428,NM,2823,55980,104,58803,5,2091,97,2188
20200428,NV,4805,35314,219,40119,13,1191,115,1306
20200428,NY,295106,549888,17638,844994,335,15789,3110,18899
20200428,OH,16128,106578,799,122706,46,2886,429,3315
20200428,OK,3410,56289,207,59699,10,6398,130,6528
20200428,OR,2354,48844,92,51198,0,0,0,0
20200428,PA,43264,165824,1716,209088,119,4452,1214,5666
20200428,PR,1400,9313,86,12653,2,0,11,11
20200428,RI,7926,49767,239,57693,6,1590,218,1808
20200428,SC,5613,46532,177,52145,3,1261,123,1384
20200428,SD,2313,14299,11,16612,0,169,68,237
20200428,TN,10052,151876,188,161928,4,7392,134,7526
20200428,TX,26171,274213,690,300384,27,8993,874,9867
20200428,UT,4343,98096,45,102439,4,2134,110,2244
20200428,VA,14339,68959,492,83858,34,1815,804,2619
20200428,VI,59,719,4,835,0,3,0,3
20200428,VT,862,14353,47,15215,0,135,7,142
20200428,WA,14824,186972,765,201796,16,6468,279,6747
20200428,WI,6289,63535,300,70017,19,2224,208,2432
20200428,WV,1079,41976,37,43055,1,0,16,16
20200428,WY,389,8226,7,8615,0,429,19,448
20200427,AK,345,15911,9,16256,0,75,4,79
20200427,AL,6499,67498,222,73997,6,217,229,446
20200427,AR,3017,37440,50,40457,1,912,76,988
20200427,AS,0,3,0,20,0,0,0,0
20200427,AZ,6716,59827,275,66543,0,1542,190,1732
20200427,CA,43464,509945,1755,553409,45,26025,1300,27325
20200427,CO,13441,49833,680,63274,8,3010,473,3483
20200427,CT,25269,54542,1998,79811,74,0,0,0
20200427,DC,3892,14524,185,18416,7,297,51,348
20200427,DE,4162,15454,125,19616,5,239,128,367
20200427,FL,32138,324325,1101,357562,7,11240,610,11850
20200427,GA,23913,103256,971,127169,59,3434,512,3946
20200427,GU,144,1424,5,1568,0,37,3,40
20200427,HI,606,28404,14,29010,0,524,3,527
20200427,IA,5868,32282,127,38150,9,1668,392,2060
20200427,ID,1897,17998,56,19895,0,320,10,330
20200427,IL,45883,181745,1983,227628,50,10696,1980,12676
20200427,IN,15961,68515,844,84476,31,1819,949,2768
20200427,KS,3328,23839,120,27167,2,786,154,940
20200427,KY,4074,44400,208,48474,3,1747,169,1916
20200427,LA,27068,119921,1697,146989,27,3658,295,3953
20200427,MA,56462,188425,3003,244887,104,7263,1524,8787
20200427,MD,19487,85489,945,104976,35,7405,906,8311
20200427,ME,1023,16784,51,17807,1,0,8,8
20200427,MI,38210,119550,3407,157760,92,6322,432,6754
20200427,MN,3816,57452,286,61268,14,2067,214,2281
20200427,MO,7171,63935,288,71106,14,1184,174,1358
20200427,MP,14,51,2,65,0,0,0,0
20200427,MS,6094,57368,229,63462,2,2491,183,2674
20200427,MT,449,12584,14,13033,0,170,1,171
20200427,NC,9142,100778,306,109920,7,1714,312,2026
20200427,ND,942,21492,19,22434,2,1642,75,1717
20200427,NE,3028,19335,56,22363,3,839,296,1135
20200427,NH,1864,17860,60,19994,0,896,77,973
20200427,NJ,111188,116587,6044,227775,106,2481,2150,4631
20200427,NM,2726,53889,99,56615,6,2814,66,2880
20200427,NV,4690,34123,206,38813,0,539,88,627
20200427,NY,291996,534099,17303,826095,337,16794,3951,20745
20200427,OH,15699,103692,753,119391,25,3269,-264,3005
20200427,OK,3280,49891,197,53171,2,0,27,27
20200427,OR,2354,48844,92,51198,1,2191,43,2234
20200427,PA,42050,161372,1597,203422,47,3944,885,4829
20200427,PR,1389,9313,84,12642,0,0,18,18
20200427,RI,7708,48177,233,55885,7,2213,269,2482
20200427,SC,5490,45271,174,50761,0,0,0,0
20200427,SD,2245,14130,11,16375,0,68,33,101
20200427,TN,9918,144484,184,154402,3,5930,251,6181
20200427,TX,25297,265220,663,290517,15,13830,666,14496
20200427,UT,4233,95962,41,100195,0,4383,110,4493
20200427,VA,13535,67144,458,81221,10,3514,565,4079
20200427,VI,59,716,4,780,0,16,2,18
20200427,VT,855,14218,47,15073,1,272,4,276
20200427,WA,14545,180504,749,195049,11,6602,350,6952
20200427,WI,6081,61311,281,67596,9,2076,170,2246
20200427,WV,1063,41976,36,43039,2,3957,19,3976
20200427,WY,370,7797,7,8167,0,0,8,8
20200426,AK,341,15836,9,16177,0,443,2,445
20200426,AL,6270,67281,216,73551,4,2074,133,2207
20200426,AR,2941,36528,49,39469,2,1304,112,1416
20200426,AS,0,3,0,20,0,0,0,0
20200426,AZ,6526,58285,275,64811,9,2057,246,2303
20200426,CA,42164,483920,1710,526084,59,19022,1027,20049
20200426,CO,12968,46823,672,59791,-2,2290,712,3002
20200426,CT,25269,54542,1924,79811,62,1522,687,2209
20200426,DC,3841,14227,178,18068,13,624,142,766
20200426,DE,4034,15215,120,19249,8,1093,458,1551
20200426,FL,31528,313085,1094,345796,19,10825,689,11514
20200426,GA,23401,99822,912,123223,8,3503,706,4209
20200426,GU,141,1387,5,1528,0,79,0,79
20200426,HI,603,27880,14,28483,1,441,2,443
20200426,IA,5476,30614,118,36090,6,1356,384,1740
20200426,ID,1887,17678,56,19565,2,187,17,204
20200426,IL,43903,171049,1933,214952,59,11209,2126,13335
20200426,IN,15012,66696,813,81708,28,1317,617,1934
20200426,KS,3174,23053,118,26227,1,910,118,1028
20200426,KY,3905,42653,205,46558,5,1470,126,1596
20200426,LA,26773,116263,1670,143036,26,3773,261,4034
20200426,MA,54938,181162,2899,236100,22,7665,1590,9255
20200426,MD,18581,78084,910,96665,35,6727,815,7542
20200426,ME,1015,16784,50,17799,0,0,25,25
20200426,MI,37778,113228,3315,151006,41,6387,575,6962
20200426,MN,3602,55385,272,58987,28,2234,156,2390
20200426,MO,6997,62751,274,69748,1,2359,171,2530
20200426,MP,14,51,2,65,0,0,0,0
20200426,MS,5911,54877,227,60788,6,1638,193,1831
20200426,MT,448,12414,14,12862,0,362,3,365
20200426,NC,8830,99064,299,107894,10,2422,207,2629
20200426,ND,867,19850,17,20717,1,1303,64,1367
20200426,NE,2732,18496,53,21228,3,944,311,1255
20200426,NH,1787,16964,60,19301,7,957,67,1024
20200426,NJ,109038,114106,5938,223144,75,5943,3515,9458
20200426,NM,2660,51075,93,53735,9,2086,139,2225
20200426,NV,4602,33584,206,38186,2,915,63,978
20200426,NY,288045,517305,16966,805350,367,21880,5902,27782
20200426,OH,15963,100423,728,116386,17,4027,376,4403
20200426,OK,3253,49891,195,53144,1,0,60,60
20200426,OR,2311,46653,91,48964,4,1529,58,1587
20200426,PA,41165,157428,1550,198593,13,4542,1116,5658
20200426,PR,1371,9313,84,12624,1,0,64,64
20200426,RI,7439,45964,226,53403,11,2202,310,2512
20200426,SC,5490,45271,174,50761,8,1510,237,1747
20200426,SD,2212,14062,11,16274,1,613,65,678
20200426,TN,9667,138554,181,148221,3,6337,478,6815
20200426,TX,24631,251390,648,276021,25,12347,858,13205
20200426,UT,4123,91579,41,95702,0,5321,175,5496
20200426,VA,12970,63630,448,77139,12,3354,604,3958
20200426,VI,57,700,4,776,1,7,2,9
20200426,VT,851,13946,46,14797,0,107,8,115
20200426,WA,14195,173902,738,188097,73,1586,107,1693
20200426,WI,5911,59235,272,65343,6,2097,224,2321
20200426,WV,1044,38019,34,39063,2,6073,24,6097
20200426,WY,362,7797,7,8159,0,0,13,13
20200425,AK,339,15393,9,15732,0,3451,0,3451
20200425,AL,6137,65207,212,71344,15,18344,305,18649
20200425,AR,2829,35224,47,38053,2,2387,88,2475
20200425,AS,0,3,0,20,0,0,0,0
20200425,AZ,6280,56228,266,62508,0,1559,235,1794
20200425,CA,41137,464898,1651,506035,89,9979,1883,11862
20200425,CO,12256,44533,674,56789,122,3471,994,4465
20200425,CT,24582,53020,1862,77602,98,2903,661,3564
20200425,DC,3699,13603,165,17302,12,598,171,769
20200425,DE,3576,14122,112,17698,12,185,134,319
20200425,FL,30839,302260,1075,334391,44,15475,665,16140
20200425,GA,22695,96319,904,119014,12,11290,548,11838
20200425,GU,141,1308,5,1449,0,75,0,75
20200425,HI,601,27439,13,28040,1,1148,5,1153
20200425,IA,5092,29258,112,34350,5,1730,647,2377
20200425,ID,1870,17491,54,19361,0,236,34,270
20200425,IL,41777,159840,1874,201617,79,9866,2119,11985
20200425,IN,14395,65379,785,79774,44,3506,715,4221
20200425,KS,3056,22143,117,25199,6,1332,279,1611
20200425,KY,3779,41183,200,44962,9,1820,298,2118
20200425,LA,26512,112490,1644,139002,43,518,372,890
20200425,MA,53348,173497,2877,226845,0,9253,2379,11632
20200425,MD,17766,71357,875,89123,77,3257,1150,4407
20200425,ME,990,16784,50,17774,3,0,25,25
20200425,MI,37203,106841,3274,144044,189,7186,562,7748
20200425,MN,3446,53151,244,56597,23,2549,261,2810
20200425,MO,6826,60392,273,67218,11,1810,201,2011
20200425,MP,14,51,2,65,0,0,0,0
20200425,MS,5718,53239,221,58957,12,3003,284,3287
20200425,MT,445,12052,14,12497,0,369,1,370
20200425,NC,8623,96642,289,105265,20,4110,571,4681
20200425,ND,803,18547,16,19350,1,1846,55,1901
20200425,NE,2421,17552,50,19973,3,1064,297,1361
20200425,NH,1720,16007,53,18125,2,868,50,918
20200425,NJ,105523,108163,5863,213686,246,4397,3327,7724
20200425,NM,2521,48989,84,51510,6,4805,142,4947
20200425,NV,4539,32669,204,37208,7,875,141,1016
20200425,NY,282143,495425,16599,777568,437,36359,10553,46912
20200425,OH,15587,96396,711,111983,21,3868,418,4286
20200425,OK,3193,49891,194,53084,6,6872,72,6944
20200425,OR,2253,45124,87,47377,1,1809,76,1885
20200425,PA,40049,152886,1537,192935,45,5395,1397,6792
20200425,PR,1307,9313,83,12560,6,0,31,31
20200425,RI,7129,43762,215,50891,13,3204,430,3634
20200425,SC,5253,43761,166,49014,16,4215,336,4551
20200425,SD,2147,13449,10,15596,0,665,107,772
20200425,TN,9189,132217,178,141406,10,9615,463,10078
20200425,TX,23773,239043,623,262816,30,19302,967,20269
20200425,UT,3948,86258,41,90206,2,5343,166,5509
20200425,VA,12366,60276,436,74047,26,2430,772,3202
20200425,VI,55,693,3,770,0,51,1,52
20200425,VT,843,13839,46,14682,2,356,16,372
20200425,WA,14088,172316,665,186404,6,3195,165,3360
20200425,WI,5687,57138,266,63066,4,2565,331,2896
20200425,WV,1020,31946,32,32966,0,3123,32,3155
20200425,WY,349,7797,7,8146,0,101,0,101
20200424,AK,339,11942,9,12281,0,118,2,120
20200424,AL,5832,46863,197,52695,0,0,54,54
20200424,AR,2741,32837,45,35578,0,3712,276,3988
20200424,AS,0,3,,20,0,0,0,0
20200424,AZ,6045,54669,266,60714,17,1741,276,2017
20200424,CA,39254,454919,1562,494173,93,10191,1885,12076
20200424,CO,11262,41062,552,52324,44,1295,384,1679
20200424,CT,23921,50117,1764,74038,125,1720,821,2541
20200424,DC,3528,13005,153,16533,14,436,167,603
20200424,DE,3442,13937,100,17379,8,333,134,467
20200424,FL,30174,286785,1031,318246,52,18909,1342,20251
20200424,GA,22147,85029,892,107176,20,5479,635,6114
20200424,GU,141,1233,5,1374,0,53,6,59
20200424,HI,596,26291,12,26887,0,755,4,759
20200424,IA,4445,27528,107,31973,11,2190,521,2711
20200424,ID,1836,17255,54,19091,0,965,34,999
20200424,IL,39658,149974,1795,189632,107,13592,2724,16316
20200424,IN,13680,61873,741,75553,35,2872,641,3513
20200424,KS,2777,20811,111,23588,-1,1975,295,2270
20200424,KY,3481,39363,191,42844,6,6661,108,6769
20200424,LA,26140,111972,1601,138112,61,198,401,599
20200424,MA,50969,164244,2877,215213,108,7920,2977,10897
20200424,MD,16616,68100,798,84716,50,3737,879,4616
20200424,ME,965,16784,47,17749,3,0,28,28
20200424,MI,36641,99655,3085,136296,108,6625,1350,7975
20200424,MN,3185,50602,221,53787,21,1996,243,2239
20200424,MO,6625,58582,262,65207,44,5453,304,5757
20200424,MP,14,51,2,65,0,0,0,0
20200424,MS,5434,50236,209,55670,8,0,281,281
20200424,MT,444,11683,14,12127,0,250,2,252
20200424,NC,8052,92532,269,100584,16,3955,444,4399
20200424,ND,748,16701,15,17449,0,1080,39,1119
20200424,NE,2124,16488,47,18612,2,941,311,1252
20200424,NH,1670,15139,51,17233,3,715,82,797
20200424,NJ,102196,103766,5617,205962,249,3607,2207,5814
20200424,NM,2379,44184,78,46563,7,5162,169,5331
20200424,NV,4398,31794,197,36192,8,1253,190,1443
20200424,NY,271590,459066,16162,730656,422,26606,8130,34736
20200424,OH,15169,92528,690,107697,34,4345,475,4820
20200424,OK,3121,43019,188,46140,9,0,104,104
20200424,OR,2177,43315,86,45492,3,1466,50,1516
20200424,PA,38652,147491,1492,186143,71,5430,1599,7029
20200424,PR,1276,9313,77,12529,8,0,361,361
20200424,RI,6699,40558,202,47257,-11,2395,437,2832
20200424,SC,4917,39546,150,44463,0,0,0,0
20200424,SD,2040,12784,10,14824,1,675,84,759
20200424,TN,8726,122602,168,131328,-2,7768,460,8228
20200424,TX,22806,219741,593,242547,32,16607,862,17469
20200424,UT,3782,80915,39,84697,4,3900,170,4070
20200424,VA,11594,57846,410,69927,38,3955,596,4551
20200424,VI,54,642,3,731,0,59,0,59
20200424,VT,827,13483,44,14310,1,456,2,458
20200424,WA,13923,169121,659,183044,5,6503,344,6847
20200424,WI,5356,54573,262,60135,5,3117,304,3421
20200424,WV,988,28823,32,29811,3,1885,21,1906
20200424,WY,349,7696,7,8045,0,455,23,478
20200423,AK,337,11824,9,12161,0,0,2,2
20200423,AL,5778,46863,197,52641,3,3568,313,3881
20200423,AR,2465,29125,45,31590,3,1688,189,1877
20200423,AS,0,3,,20,0,0,0,0
20200423,AZ,5769,52928,249,58697,20,1786,310,2096
20200423,CA,37369,444728,1469,482097,115,14797,1973,16770
20200423,CO,10878,39767,508,50645,22,1510,431,1941
20200423,CT,23100,48397,1639,71497,95,948,631,1579
20200423,DC,3361,12569,139,15930,12,273,155,428
20200423,DE,3308,13604,92,16912,3,251,108,359
20200423,FL,28832,267876,979,298009,69,7558,523,8081
20200423,GA,21512,79550,872,101062,36,6218,772,6990
20200423,GU,135,1180,5,1315,0,94,1,95
20200423,HI,592,25536,12,26128,0,776,10,786
20200423,IA,3924,25338,96,29262,6,842,176,1018
20200423,ID,1802,16290,54,18092,3,326,36,362
20200423,IL,36934,136382,1688,173316,123,7144,1826,8970
20200423,IN,13039,59001,706,72040,45,1969,601,2570
20200423,KS,2482,18836,112,21318,2,844,271,1115
20200423,KY,3373,32702,185,36075,14,2566,181,2747
20200423,LA,25739,111774,1540,137513,67,186,481,667
20200423,MA,47992,156324,2769,204316,172,11535,3079,14614
20200423,MD,15737,64363,748,80100,50,2609,962,3571
20200423,ME,937,16784,44,17721,5,0,30,30
20200423,MI,35291,93030,2977,128321,164,8771,1325,10096
20200423,MN,2942,48606,200,51548,21,1983,221,2204
20200423,MO,6321,53129,218,59450,10,1110,184,1294
20200423,MP,14,51,2,65,0,0,0,0
20200423,MS,5153,50236,201,55389,8,1295,259,1554
20200423,MT,442,11433,14,11875,0,289,3,292
20200423,NC,7608,88577,253,96185,11,5461,388,5849
20200423,ND,709,15621,15,16330,1,711,30,741
20200423,NE,1813,15547,45,17360,7,590,91,681
20200423,NH,1588,14424,48,16277,6,874,97,971
20200423,NJ,99989,100159,5368,200148,305,4365,4124,8489
20200423,NM,2210,39022,71,41232,6,217,138,355
20200423,NV,4208,30541,189,34749,17,734,127,861
20200423,NY,263460,432460,15740,695920,438,19694,6244,25938
20200423,OH,14694,88183,656,102877,46,3794,577,4371
20200423,OK,3017,43019,179,46036,9,0,123,123
20200423,OR,2127,41849,83,43976,5,2723,68,2791
20200423,PA,37053,142061,1421,179114,-201,5789,1369,7158
20200423,PR,915,9313,69,12179,2,471,0,471
20200423,RI,6262,38163,213,44425,12,2282,417,2699
20200423,SC,4917,39546,150,44463,10,1196,156,1352
20200423,SD,1956,12109,9,14065,1,521,98,619
20200423,TN,8266,114834,170,123100,4,7696,424,8120
20200423,TX,21944,203134,561,225078,18,7420,875,8295
20200423,UT,3612,77015,35,80627,1,4000,167,4167
20200423,VA,10998,53891,372,65381,23,3379,732,4111
20200423,VI,54,583,3,668,0,0,0,0
20200423,VT,825,13027,43,13852,3,388,2,390
20200423,WA,13579,162618,654,176197,7,5143,260,5403
20200423,WI,5052,51456,257,56709,11,1954,207,2161
20200423,WV,967,26938,29,27905,3,2041,28,2069
20200423,WY,326,7241,7,7567,1,-60,4,-56
20200422,AK,335,11824,9,12159,0,1034,6,1040
20200422,AL,5465,43295,194,48760,17,0,234,234
20200422,AR,2276,27437,42,29713,-1,2223,49,2272
20200422,AS,0,3,,20,0,0,0,0
20200422,AZ,5459,51142,229,56601,21,1241,208,1449
20200422,CA,35396,429931,1354,465327,86,163092,2135,165227
20200422,CO,10447,38257,486,48704,37,897,341,1238
20200422,CT,22469,47449,1544,69918,121,3617,2109,5726
20200422,DC,3206,12296,127,15502,15,455,108,563
20200422,DE,3200,13353,89,16553,7,-372,269,-103
20200422,FL,28309,260318,910,289885,54,10754,814,11568
20200422,GA,20740,73332,836,94072,37,5073,859,5932
20200422,GU,134,1086,5,1220,0,53,1,54
20200422,HI,582,24760,12,25342,2,648,-2,646
20200422,IA,3748,24496,90,28244,7,522,107,629
20200422,ID,1766,15964,51,17730,3,40,30,70
20200422,IL,35108,129238,1565,164346,97,7300,2049,9349
20200422,IN,12438,57032,661,69470,31,1865,341,2206
20200422,KS,2211,17992,110,20203,3,916,186,1102
20200422,KY,3192,30136,171,33328,17,366,142,508
20200422,LA,25258,111588,1473,136846,68,0,404,404
20200422,MA,44913,144789,2597,189702,148,3345,1745,5090
20200422,MD,14775,61754,698,76529,46,2312,582,2894
20200422,ME,907,16784,39,17691,3,2708,19,2727
20200422,MI,33966,84259,2813,118225,113,0,999,999
20200422,MN,2721,46623,179,49344,19,1493,154,1647
20200422,MO,6137,52019,208,58156,19,840,196,1036
20200422,MP,14,51,2,65,0,0,0,0
20200422,MS,4894,48941,193,53835,10,1293,178,1471
20200422,MT,439,11144,14,11583,2,340,2,342
20200422,NC,7220,83116,242,90336,29,6736,269,7005
20200422,ND,679,14910,14,15589,1,567,35,602
20200422,NE,1722,14957,38,16679,5,233,74,307
20200422,NH,1491,13550,42,15266,0,702,0,702
20200422,NJ,95865,95794,5063,191659,310,3355,3478,6833
20200422,NM,2072,38805,65,40877,7,2021,101,2122
20200422,NV,4081,29807,172,33888,9,689,144,833
20200422,NY,257216,412766,15302,669982,474,15131,5526,20657
20200422,OH,14117,84389,610,98506,53,3400,392,3792
20200422,OK,2894,43019,170,45913,6,1482,87,1569
20200422,OR,2059,39126,78,41185,0,0,57,57
20200422,PA,35684,136272,1622,171956,58,3949,1156,5105
20200422,PR,915,8842,67,11711,3,53,-383,-330
20200422,RI,5845,35881,201,41726,15,2048,378,2426
20200422,SC,4761,38350,140,43111,16,1512,322,1834
20200422,SD,1858,11588,8,13446,0,528,103,631
20200422,TN,7842,107138,166,114980,9,6350,448,6798
20200422,TX,21069,195714,543,216783,26,10511,873,11384
20200422,UT,3445,73015,34,76460,2,3953,149,4102
20200422,VA,10266,50512,349,61255,25,1788,636,2424
20200422,VI,54,583,3,668,0,9,0,9
20200422,VT,823,12639,40,13462,0,346,5,351
20200422,WA,13319,157475,647,170794,7,4969,276,5245
20200422,WI,4845,49502,246,54576,4,1661,225,1886
20200422,WV,939,24897,26,25836,0,3048,25,3073
20200422,WY,322,7301,6,7623,0,0,2,2
20200421,AK,329,10790,9,11119,0,987,8,995
20200421,AL,5231,43295,177,48526,10,2420,206,2626
20200421,AR,2227,25214,43,27441,1,584,304,888
20200421,AS,0,3,,20,0,0,0,0
20200421,AZ,5251,49901,208,55152,21,465,187,652
20200421,CA,33261,266839,1268,300100,60,7317,2283,9600
20200421,CO,10106,37360,449,47466,27,895,376,1271
20200421,CT,20360,43832,1423,64192,92,841,545,1386
20200421,DC,3098,11841,112,14939,7,655,171,826
20200421,DE,2931,13725,82,16656,10,0,186,186
20200421,FL,27495,249564,856,278262,50,9999,835,10834
20200421,GA,19881,68259,799,88140,66,2878,934,3812
20200421,GU,133,1033,5,1166,0,42,0,42
20200421,HI,584,24112,10,24696,0,517,4,521
20200421,IA,3641,23974,83,27615,4,1313,482,1795
20200421,ID,1736,15924,48,17660,3,151,64,215
20200421,IL,33059,121938,1468,154997,119,5088,1551,6639
20200421,IN,12097,55167,630,67264,61,2214,411,2625
20200421,KS,2025,17076,107,19101,7,301,39,340
20200421,KY,3050,29770,154,32820,6,158,90,248
20200421,LA,24854,111588,1405,136442,77,0,331,331
20200421,MA,43168,141444,2449,184612,146,5398,1752,7150
20200421,MD,14193,59442,652,73635,70,1729,509,2238
20200421,ME,888,14076,36,14964,1,0,13,13
20200421,MI,32967,84259,2700,117226,232,2461,967,3428
20200421,MN,2567,45130,160,47697,17,750,97,847
20200421,MO,5941,51179,189,57120,12,973,134,1107
20200421,MP,14,51,2,65,0,0,0,0
20200421,MS,4716,47648,183,52364,14,726,204,930
20200421,MT,437,10804,12,11241,2,186,4,190
20200421,NC,6951,76380,213,83331,34,3660,187,3847
20200421,ND,644,14343,13,14987,0,223,17,240
20200421,NE,1648,14724,33,16372,5,518,174,692
20200421,NH,1491,12848,42,14583,1,122,99,221
20200421,NJ,92387,92439,4753,184826,376,3188,3581,6769
20200421,NM,1971,36784,58,38755,3,1587,126,1713
20200421,NV,3937,29118,163,33055,5,601,107,708
20200421,NY,251690,397635,14828,649325,481,11286,4178,15464
20200421,OH,13725,80989,557,94714,48,3069,806,3875
20200421,OK,2807,41537,164,44344,21,8571,127,8698
20200421,OR,2002,39126,78,41128,3,1037,46,1083
20200421,PA,34528,132323,1564,166851,360,2603,1296,3899
20200421,PR,1298,8789,64,11848,1,303,46,349
20200421,RI,5467,33833,186,39300,11,1843,369,2212
20200421,SC,4439,36838,124,41277,4,735,62,797
20200421,SD,1755,11060,8,12815,1,419,70,489
20200421,TN,7394,100788,157,108182,5,7337,156,7493
20200421,TX,20196,185203,517,205399,22,14267,738,15005
20200421,UT,3296,69062,32,72358,4,3964,83,4047
20200421,VA,9630,48724,324,58831,24,979,640,1619
20200421,VI,54,574,3,663,0,20,1,21
20200421,VT,818,12293,40,13111,2,128,2,130
20200421,WA,13043,152506,640,165549,11,4807,263,5070
20200421,WI,4620,47841,242,52680,12,1238,121,1359
20200421,WV,914,21849,26,22763,2,596,12,608
20200421,WY,320,7301,6,7621,4,228,7,235
20200420,AK,321,9803,9,10124,0,227,2,229
20200420,AL,5025,40875,167,45900,13,0,188,188
20200420,AR,1923,24630,42,26553,2,2202,142,2344
20200420,AS,0,3,,20,0,0,0,0
20200420,AZ,5064,49436,187,54500,3,1375,135,1510
20200420,CA,30978,259522,1208,290500,42,8955,645,9600
20200420,CO,9730,36465,422,46195,11,1292,297,1589
20200420,CT,19815,42991,1331,62806,245,2328,2265,4593
20200420,DC,2927,11186,105,14113,9,280,134,414
20200420,DE,2745,13725,72,16470,5,1469,207,1676
20200420,FL,26660,239565,806,267329,25,9482,664,10146
20200420,GA,18947,65381,733,84328,46,3749,646,4395
20200420,GU,133,991,5,1124,0,48,0,48
20200420,HI,580,23595,10,24175,1,699,6,705
20200420,IA,3159,22661,79,25820,4,1013,257,1270
20200420,ID,1672,15773,45,17445,1,572,4,576
20200420,IL,31508,116850,1349,148358,59,3889,1151,5040
20200420,IN,11686,52953,569,64639,7,3021,476,3497
20200420,KS,1986,16775,100,18761,8,494,137,631
20200420,KY,2960,29612,148,32572,4,94,253,347
20200420,LA,24523,111588,1328,136111,32,168,595,763
20200420,MA,41416,136046,2303,177462,157,6751,1596,8347
20200420,MD,13684,57713,582,71397,34,2652,854,3506
20200420,ME,875,14076,35,14951,1,0,8,8
20200420,MI,32000,81798,2468,113798,77,3561,576,4137
20200420,MN,2470,44380,143,46850,9,1020,114,1134
20200420,MO,5807,50206,177,56013,1,1964,140,2104
20200420,MP,14,51,2,65,0,9,0,9
20200420,MS,4512,46922,169,51434,10,12131,238,12369
20200420,MT,433,10618,10,11051,0,153,0,153
20200420,NC,6764,72720,179,79484,7,441,271,712
20200420,ND,627,14120,13,14747,3,1075,42,1117
20200420,NE,1474,14206,28,15680,0,918,187,1105
20200420,NH,1392,12726,41,14416,3,644,50,694
20200420,NJ,88806,89251,4377,178057,175,3864,3505,7369
20200420,NM,1845,35197,55,37042,2,363,47,410
20200420,NV,3830,28517,158,32347,3,647,102,749
20200420,NY,247512,386349,14347,633861,478,11580,4726,16306
20200420,OH,12919,77920,509,90839,38,2223,1317,3540
20200420,OK,2680,32966,143,35646,3,0,81,81
20200420,OR,1956,38089,75,40045,1,961,46,1007
20200420,PA,33232,129720,1204,162952,92,3150,948,4098
20200420,PR,1252,8486,63,11633,1,206,39,245
20200420,RI,5098,31990,175,37088,11,1997,343,2340
20200420,SC,4377,36103,120,40480,0,0,0,0
20200420,SD,1685,10641,7,12326,0,214,50,264
20200420,TN,7238,93451,152,100689,4,3423,168,3591
20200420,TX,19458,170936,495,190394,18,7149,535,7684
20200420,UT,3213,65098,28,68311,1,4612,144,4756
20200420,VA,8990,47745,300,57203,23,1549,453,2002
20200420,VI,53,554,3,625,0,6,0,6
20200420,VT,816,12165,38,12981,0,251,4,255
20200420,WA,12780,147699,629,160479,14,4349,322,4671
20200420,WI,4499,46603,230,51339,10,1280,153,1433
20200420,WV,902,21253,24,22155,6,2085,39,2124
20200420,WY,313,7073,2,7386,0,101,4,105
20200419,AK,319,9576,9,9895,0,235,5,240
20200419,AL,4837,40875,154,45712,8,2992,182,3174
20200419,AR,1781,22428,40,24209,2,26,42,68
20200419,AS,0,3,,20,0,0,0,0
20200419,AZ,4929,48061,184,52990,7,1735,210,1945
20200419,CA,30333,250567,1166,288100,94,19864,1370,21234
20200419,CO,9433,35173,411,44606,20,913,386,1299
20200419,CT,17550,40663,1086,58213,50,2010,741,2751
20200419,DC,2793,10906,96,13699,5,304,127,431
20200419,DE,2538,12256,67,14794,6,562,215,777
20200419,FL,25996,230083,781,257258,27,8825,727,9552
20200419,GA,18301,61632,687,79933,14,5093,632,5725
20200419,GU,133,943,5,1076,0,0,0,0
20200419,HI,574,22896,9,23470,0,1106,21,1127
20200419,IA,2902,21648,75,24550,1,1214,389,1603
20200419,ID,1668,15201,44,16869,1,247,13,260
20200419,IL,30357,112961,1290,143318,31,4717,1197,5914
20200419,IN,11210,49932,562,61142,17,3700,569,4269
20200419,KS,1849,16281,92,18130,6,395,59,454
20200419,KY,2707,29518,144,32225,7,1444,185,1629
20200419,LA,23928,111420,1296,135348,29,-2999,348,-2651
20200419,MA,39820,129295,2146,169115,163,4691,2293,6984
20200419,MD,12830,55061,548,67891,14,1999,522,2521
20200419,ME,867,14076,34,14943,2,0,20,20
20200419,MI,31424,78237,2391,109661,83,9301,633,9934
20200419,MN,2356,43360,134,45716,13,1305,143,1448
20200419,MO,5667,48242,176,53909,1,0,150,150
20200419,MP,14,42,2,60,0,0,0,0
20200419,MS,4274,34791,159,39065,7,0,300,300
20200419,MT,433,10465,10,10898,0,322,7,329
20200419,NC,6493,72279,172,78772,8,2208,353,2561
20200419,ND,585,13045,10,13630,1,610,57,667
20200419,NE,1287,13288,28,14575,4,749,149,898
20200419,NH,1342,12082,38,13740,1,517,55,572
20200419,NJ,85301,85387,4202,170688,132,4271,3881,8152
20200419,NM,1798,34834,53,36632,2,932,87,1019
20200419,NV,3728,27870,155,31598,4,745,102,847
20200419,NY,242786,374769,13869,617555,507,14969,6054,21023
20200419,OH,11602,75697,471,87299,20,6878,1380,8258
20200419,OK,2599,32966,140,35565,1,0,29,29
20200419,OR,1910,37128,74,39038,2,1389,66,1455
20200419,PA,32284,126570,1112,158854,276,3674,1215,4889
20200419,PR,1213,8280,62,11332,2,225,95,320
20200419,RI,4755,29993,164,34748,14,1658,276,1934
20200419,SC,4377,36103,120,40480,1,1516,131,1647
20200419,SD,1635,10427,7,12062,0,309,93,402
20200419,TN,7070,90028,148,97098,3,6204,308,6512
20200419,TX,18923,163787,477,182710,24,5808,663,6471
20200419,UT,3069,60486,27,63555,2,3473,138,3611
20200419,VA,8537,46196,277,55232,19,2318,484,2802
20200419,VI,53,548,3,623,0,158,0,158
20200419,VT,812,11914,38,12726,0,151,9,160
20200419,WA,12458,143350,615,155808,17,1433,89,1522
20200419,WI,4346,45323,220,49917,9,1361,147,1508
20200419,WV,863,19168,18,20031,2,513,78,591
20200419,WY,309,6972,2,7281,0,755,4,759
20200418,AK,314,9341,9,9655,0,200,5,205
20200418,AL,4655,37883,146,42538,2,4565,125,4690
20200418,AR,1739,22402,38,24141,1,603,44,647
20200418,AS,0,3,,20,0,0,0,0
20200418,AZ,4719,46326,177,51045,8,1603,212,1815
20200418,CA,28963,230703,1072,266866,87,6617,1435,8052
20200418,CO,9047,34260,391,43307,17,1105,372,1477
20200418,CT,16809,38653,1036,55462,0,0,0,0
20200418,DC,2666,10602,91,13268,5,435,190,625
20200418,DE,2323,11694,61,14017,0,0,0,0
20200418,FL,25269,221258,754,246527,55,10540,1150,11690
20200418,GA,17669,56539,673,74208,23,2049,475,2524
20200418,GU,133,943,5,1076,0,3,0,3
20200418,HI,553,21790,9,22343,0,474,12,486
20200418,IA,2513,20434,74,22947,10,974,181,1155
20200418,ID,1655,14954,43,16609,2,380,46,426
20200418,IL,29160,108244,1259,137404,125,5656,1585,7241
20200418,IN,10641,46232,545,56873,26,1601,487,2088
20200418,KS,1790,15886,86,17676,2,690,85,775
20200418,KY,2522,28074,137,30596,8,756,93,849
20200418,LA,23580,114419,1267,137999,54,5550,462,6012
20200418,MA,37527,124604,1983,162131,161,7409,2402,9811
20200418,MD,12308,53062,534,65370,40,2625,736,3361
20200418,ME,847,14076,32,14923,3,0,20,20
20200418,MI,30791,68936,2308,99727,81,0,768,768
20200418,MN,2213,42055,121,44268,10,1073,142,1215
20200418,MO,5517,48242,175,53759,10,1808,234,2042
20200418,MP,14,42,2,60,0,0,1,1
20200418,MS,3974,34791,152,38765,12,0,181,181
20200418,MT,426,10143,10,10569,2,321,4,325
20200418,NC,6140,70071,164,76211,12,2949,281,3230
20200418,ND,528,12435,9,12963,0,532,89,621
20200418,NE,1138,12539,24,13677,0,501,72,573
20200418,NH,1287,11565,37,13026,0,144,0,144
20200418,NJ,81420,81116,4070,162536,230,2134,2953,5087
20200418,NM,1711,33902,51,35613,7,1011,114,1125
20200418,NV,3626,27125,151,30751,9,887,102,989
20200418,NY,236732,359800,13362,596532,540,16219,7090,23309
20200418,OH,10222,68819,451,79041,33,0,1115,1115
20200418,OK,2570,32966,139,35536,3,1811,105,1916
20200418,OR,1844,35739,72,37583,2,1203,59,1262
20200418,PA,31069,122896,836,153965,80,4964,1628,6592
20200418,PR,1118,8055,60,10933,2,191,50,241
20200418,RI,4479,28335,150,32814,32,1751,302,2053
20200418,SC,4246,34587,119,38833,10,2234,315,2549
20200418,SD,1542,10118,7,11661,0,467,131,598
20200418,TN,6762,83824,145,90586,3,3140,173,3313
20200418,TX,18260,157979,453,176239,25,5814,889,6703
20200418,UT,2931,57013,25,59944,2,4047,126,4173
20200418,VA,8053,43878,258,52417,27,2372,562,2934
20200418,VI,53,390,3,478,1,17,2,19
20200418,VT,803,11763,38,12566,3,426,24,450
20200418,WA,12369,141917,598,154286,13,2057,169,2226
20200418,WI,4199,43962,211,48390,6,1597,154,1751
20200418,WV,785,18655,16,19440,3,728,31,759
20200418,WY,305,6217,2,6522,0,86,9,95
20200417,AK,309,9141,9,9450,0,706,9,715
20200417,AL,4530,33318,144,37848,11,1272,185,1457
20200417,AR,1695,21799,37,23494,0,744,75,819
20200417,AS,0,3,,20,0,0,0,0
20200417,AZ,4507,44723,169,49230,19,1559,273,1832
20200417,CA,27528,224086,985,258814,95,3868,1346,5214
20200417,CO,8675,33155,374,41830,17,902,395,1297
20200417,CT,16809,38653,1036,55462,65,1415,925,2340
20200417,DC,2476,10167,86,12643,5,367,126,493
20200417,DE,2323,11694,61,14017,9,419,248,667
20200417,FL,24119,210718,699,236122,53,14367,1222,15589
20200417,GA,17194,54490,650,71684,63,2220,1525,3745
20200417,GU,133,940,5,1073,0,70,0,70
20200417,HI,541,21316,9,21857,0,1146,11,1157
20200417,IA,2332,19460,64,21792,4,926,191,1117
20200417,ID,1609,14574,41,16183,0,330,22,352
20200417,IL,27575,102588,1134,130163,62,5732,1842,7574
20200417,IN,10154,44631,519,54785,42,3058,612,3670
20200417,KS,1705,15196,84,16901,4,662,117,779
20200417,KY,2429,27318,129,29747,7,1285,138,1423
20200417,LA,23118,108869,1213,131987,57,4815,586,5401
20200417,MA,35125,117195,1822,152320,155,7097,2633,9730
20200417,MD,11572,50437,494,62009,35,2378,788,3166
20200417,ME,827,14076,29,14903,2,0,31,31
20200417,MI,30023,68936,2227,98959,134,3913,760,4673
20200417,MN,2071,40982,111,43053,17,1219,159,1378
20200417,MO,5283,46434,165,51717,13,897,172,1069
20200417,MP,13,42,2,59,0,15,0,15
20200417,MS,3793,34791,140,38584,11,0,169,169
20200417,MT,422,9822,8,10244,1,301,7,308
20200417,NC,5859,67122,152,72981,21,1670,394,2064
20200417,ND,439,11903,9,12342,0,592,46,638
20200417,NE,1066,12038,24,13104,3,696,114,810
20200417,NH,1287,11421,37,12882,5,394,148,542
20200417,NJ,78467,78982,3840,157449,322,2469,3150,5619
20200417,NM,1597,32891,44,34488,8,981,113,1094
20200417,NV,3524,26238,142,29762,5,1108,203,1311
20200417,NY,229642,343581,12822,573223,630,15286,7358,22644
20200417,OH,9107,68819,418,77926,29,2393,693,3086
20200417,OK,2465,31155,136,33620,5,2613,108,2721
20200417,OR,1785,34536,70,36321,6,1334,49,1383
20200417,PA,29441,117932,756,147373,49,4197,1706,5903
20200417,PR,1068,7864,58,10410,2,549,25,574
20200417,RI,4177,26584,118,30761,13,2358,339,2697
20200417,SC,3931,32353,109,36284,2,1276,275,1551
20200417,SD,1411,9651,7,11062,0,412,100,512
20200417,TN,6589,80684,142,87273,1,1897,327,2224
20200417,TX,17371,152165,428,169536,35,10073,916,10989
20200417,UT,2805,52966,23,55771,2,5971,122,6093
20200417,VA,7491,41506,231,49496,23,1951,602,2553
20200417,VI,51,373,2,458,1,16,0,16
20200417,VT,779,11337,35,12116,0,598,11,609
20200417,WA,12200,139860,585,152060,14,4042,341,4383
20200417,WI,4045,42365,205,46608,8,1391,170,1561
20200417,WV,754,17927,13,18681,0,360,15,375
20200417,WY,296,6131,2,6427,0,0,0,0
20200416,AK,300,8435,9,8735,0,64,7,71
20200416,AL,4345,32046,133,36391,12,2082,232,2314
20200416,AR,1620,21055,37,22675,4,790,51,841
20200416,AS,0,3,,20,0,0,0,0
20200416,AZ,4234,43164,150,47398,8,1816,272,2088
20200416,CA,26182,220218,890,259600,69,28156,1758,29914
20200416,CO,8280,32253,357,40533,28,614,339,953
20200416,CT,15884,37238,971,53122,103,1850,1129,2979
20200416,DC,2350,9800,81,12150,9,472,153,625
20200416,DE,2075,11275,52,13350,6,187,61,248
20200416,FL,22897,196351,646,220573,37,5353,386,5739
20200416,GA,15669,52270,587,67939,35,3167,682,3849
20200416,GU,133,870,5,1003,0,27,0,27
20200416,HI,530,20170,9,20700,0,884,13,897
20200416,IA,2141,18534,60,20675,7,660,146,806
20200416,ID,1587,14244,41,15831,2,310,123,433
20200416,IL,25733,96856,1072,122589,124,4520,1140,5660
20200416,IN,9542,41573,477,51115,41,2132,587,2719
20200416,KS,1588,14534,80,16122,4,1360,94,1454
20200416,KY,2291,26033,122,28324,7,546,81,627
20200416,LA,22532,104054,1156,126586,53,4077,581,4658
20200416,MA,32492,110098,1667,142590,165,7308,2522,9830
20200416,MD,10784,48059,459,58843,46,2328,752,3080
20200416,ME,796,14076,27,14872,3,0,26,26
20200416,MI,29263,65023,2093,94286,172,3385,1204,4589
20200416,MN,1912,39763,94,41675,7,1330,103,1433
20200416,MO,5111,45537,152,50648,5,1420,216,1636
20200416,MP,13,27,2,47,0,0,0,0
20200416,MS,3624,34791,129,38415,7,0,264,264
20200416,MT,415,9521,7,9936,0,342,11,353
20200416,NC,5465,65452,131,70917,14,2748,342,3090
20200416,ND,393,11311,9,11704,0,359,28,387
20200416,NE,952,11342,21,12294,1,514,51,565
20200416,NH,1139,11027,32,12287,0,0,0,0
20200416,NJ,75317,76513,3518,151830,362,3522,4287,7809
20200416,NM,1484,31910,36,33394,0,467,77,544
20200416,NV,3321,25130,137,28451,6,686,110,796
20200416,NY,222284,328295,12192,550579,606,16062,8505,24567
20200416,OH,8414,66426,389,74840,28,2665,623,3288
20200416,OK,2357,28542,131,30899,8,1586,94,1680
20200416,OR,1736,33202,64,34938,6,1514,73,1587
20200416,PA,27735,113735,707,141470,60,2641,1245,3886
20200416,PR,1043,7315,56,9823,5,490,69,559
20200416,RI,3838,24226,105,28064,18,1858,309,2167
20200416,SC,3656,31077,107,34733,0,0,0,0
20200416,SD,1311,9239,7,10552,1,548,143,691
20200416,TN,6262,78787,141,85049,6,3970,183,4153
20200416,TX,16455,142092,393,158547,29,5774,963,6737
20200416,UT,2683,46995,21,49678,1,1923,141,2064
20200416,VA,6889,39555,208,46981,13,1886,389,2275
20200416,VI,51,357,1,443,0,26,0,26
20200416,VT,768,10739,35,11507,5,417,9,426
20200416,WA,11859,135818,571,147677,20,3969,304,4273
20200416,WI,3875,40974,197,45067,15,1648,154,1802
20200416,WV,739,17567,13,18306,3,613,37,650
20200416,WY,296,6131,2,6427,0,89,9,98
20200415,AK,293,8371,9,8664,0,308,8,316
20200415,AL,4113,29964,121,34077,11,723,237,960
20200415,AR,1569,20265,33,21834,3,614,89,703
20200415,AS,0,3,,20,0,0,0,0
20200415,AZ,3962,41348,142,45310,11,1058,156,1214
20200415,CA,24424,192062,821,229686,63,13192,1086,14278
20200415,CO,7941,31639,329,39580,21,588,250,838
20200415,CT,14755,35388,868,50143,197,3536,766,4302
20200415,DC,2197,9328,72,11525,5,102,139,241
20200415,DE,2014,11088,46,13102,5,545,253,798
20200415,FL,22511,190998,609,214844,72,9185,1144,10329
20200415,GA,14987,49103,552,64090,51,1531,764,2295
20200415,GU,133,843,5,976,0,32,0,32
20200415,HI,517,19286,9,19803,0,370,13,383
20200415,IA,1995,17874,53,19869,4,888,96,984
20200415,ID,1464,13934,39,15398,6,273,11,284
20200415,IL,24593,92336,948,116929,80,4967,1346,6313
20200415,IN,8955,39441,436,48396,48,1951,428,2379
20200415,KS,1494,13174,76,14668,7,453,68,521
20200415,KY,2210,25487,115,27697,11,852,162,1014
20200415,LA,21951,99977,1103,121928,90,3073,433,3506
20200415,MA,29970,102790,1502,132760,173,3970,1861,5831
20200415,MD,10032,45731,413,55763,111,1470,560,2030
20200415,ME,770,14076,24,14846,4,2468,36,2504
20200415,MI,28059,61638,1921,89697,153,2413,1058,3471
20200415,MN,1809,38433,87,40242,8,887,114,1001
20200415,MO,4895,44117,147,49012,14,825,209,1034
20200415,MP,13,27,2,47,0,0,0,0
20200415,MS,3360,34791,122,38151,11,0,273,273
20200415,MT,404,9179,7,9583,0,344,5,349
20200415,NC,5123,62704,117,67827,9,2689,99,2788
20200415,ND,365,10952,9,11317,0,377,24,401
20200415,NE,901,10828,20,11729,2,342,30,372
20200415,NH,1139,11027,32,12287,9,437,119,556
20200415,NJ,71030,72991,3156,144021,351,2041,2206,4247
20200415,NM,1407,31443,36,32850,5,818,62,880
20200415,NV,3211,24444,131,27655,11,871,123,994
20200415,NY,213779,312233,11586,526012,752,15298,11571,26869
20200415,OH,7791,63761,361,71552,37,3040,511,3551
20200415,OK,2263,26956,123,29219,15,871,79,950
20200415,OR,1663,31688,58,33351,3,958,30,988
20200415,PA,26490,111094,647,137584,63,2808,1145,3953
20200415,PR,974,6825,51,9209,6,541,51,592
20200415,RI,3529,22368,87,25897,7,2719,278,2997
20200415,SC,3656,31077,107,34733,10,758,103,861
20200415,SD,1168,8691,6,9859,0,383,180,563
20200415,TN,6079,74817,135,80896,11,1809,256,2065
20200415,TX,15492,136318,364,151810,46,4475,868,5343
20200415,UT,2542,45072,20,47614,1,1008,130,1138
20200415,VA,6500,37669,195,44665,41,1077,329,1406
20200415,VI,51,331,1,417,0,5,0,5
20200415,VT,759,10322,30,11081,1,489,7,496
20200415,WA,11555,131849,551,143404,9,3794,323,4117
20200415,WI,3721,39326,182,43327,12,1329,166,1495
20200415,WV,702,16954,10,17656,1,556,62,618
20200415,WY,287,6042,2,6329,1,353,12,365
20200414,AK,285,8063,9,8348,1,510,8,518
20200414,AL,3876,29241,110,33117,11,3793,142,3935
20200414,AR,1480,19651,30,21131,0,257,70,327
20200414,AS,0,3,,20,0,0,0,0
20200414,AZ,3806,40290,131,44096,9,645,104,749
20200414,CA,23338,178870,758,215408,71,10336,990,11326
20200414,CO,7691,31051,308,38742,4,1201,7,1208
20200414,CT,13989,31852,671,45841,69,924,608,1532
20200414,DC,2058,9226,67,11284,14,247,103,350
20200414,DE,1761,10543,41,12304,6,348,136,484
20200414,FL,21367,181813,537,204455,54,6207,766,6973
20200414,GA,14223,47572,501,61795,37,3866,908,4774
20200414,GU,133,811,5,944,0,41,0,41
20200414,HI,504,18916,9,19420,0,571,5,576
20200414,IA,1899,16986,49,18885,6,0,189,189
20200414,ID,1453,13661,33,15114,6,206,27,233
20200414,IL,23247,87369,868,110616,74,3626,1222,4848
20200414,IN,8527,37490,388,46017,38,1187,291,1478
20200414,KS,1426,12721,69,14147,7,233,50,283
20200414,KY,2048,24635,104,26683,7,732,85,817
20200414,LA,21518,96904,1013,118422,129,9829,502,10331
20200414,MA,28109,98820,1329,126929,118,3320,1315,4635
20200414,MD,9472,44261,302,53733,40,1446,536,1982
20200414,ME,734,11608,20,12342,1,0,36,36
20200414,MI,27001,59225,1768,86226,166,2216,1366,3582
20200414,MN,1695,37546,79,39241,9,769,45,814
20200414,MO,4686,43292,133,47978,19,2252,298,2550
20200414,MP,13,27,2,47,0,0,2,2
20200414,MS,3087,34791,111,37878,13,6749,145,6894
20200414,MT,399,8835,7,9234,0,131,5,136
20200414,NC,5024,60015,108,65039,22,1443,208,1651
20200414,ND,341,10575,9,10916,1,125,10,135
20200414,NE,871,10486,18,11357,1,328,57,385
20200414,NH,1020,10590,23,11635,0,368,35,403
20200414,NJ,68824,70950,2805,139774,362,6065,4240,10305
20200414,NM,1345,30625,31,31970,5,1355,100,1455
20200414,NV,3088,23573,120,26661,6,1080,117,1197
20200414,NY,202208,296935,10834,499143,778,13609,7177,20786
20200414,OH,7280,60721,324,68001,50,2584,305,2889
20200414,OK,2184,26085,108,28269,9,5295,115,5410
20200414,OR,1633,30730,55,32363,2,1193,49,1242
20200414,PA,25345,108286,584,133631,60,2693,1146,3839
20200414,PR,923,6284,45,8529,0,324,20,344
20200414,RI,3251,19649,80,22900,7,1964,275,2239
20200414,SC,3553,30319,97,33872,15,2213,234,2447
20200414,SD,988,8308,6,9296,0,174,120,294
20200414,TN,5823,73008,124,78831,15,2423,213,2636
20200414,TX,14624,131843,318,146467,31,12523,718,13241
20200414,UT,2412,44064,19,46476,1,640,49,689
20200414,VA,6171,36592,154,43232,5,938,424,1362
20200414,VI,51,326,1,400,0,4,0,4
20200414,VT,752,9833,29,10585,1,215,4,219
20200414,WA,11232,128055,542,139287,16,3931,291,4222
20200414,WI,3555,37997,170,41829,16,1228,127,1355
20200414,WV,640,16398,9,17038,0,369,14,383
20200414,WY,275,5689,1,5964,0,0,0,0
20200413,AK,277,7553,8,7830,0,-213,5,-208
20200413,AL,3734,25448,99,29182,6,7390,209,7599
20200413,AR,1410,19394,30,20804,3,952,130,1082
20200413,AS,0,3,,3,0,0,0,0
20200413,AZ,3702,39645,122,43347,7,1075,163,1238
20200413,CA,22348,168534,687,204082,36,0,554,554
20200413,CO,7684,29850,304,37534,30,1870,791,2661
20200413,CT,13381,30928,602,44309,48,1743,1346,3089
20200413,DC,1955,8979,53,10934,3,214,80,294
20200413,DE,1625,10195,35,11820,2,571,146,717
20200413,FL,20601,175606,483,197996,18,12208,1246,13454
20200413,GA,13315,43706,464,57021,31,1705,863,2568
20200413,GU,133,770,5,903,0,77,0,77
20200413,HI,499,18345,9,18844,1,863,13,876
20200413,IA,1710,16986,43,18696,2,981,123,1104
20200413,ID,1426,13455,27,14881,0,554,19,573
20200413,IL,22025,83743,794,105768,74,3860,1173,5033
20200413,IN,8236,36303,350,44539,7,1742,308,2050
20200413,KS,1376,12488,62,13864,6,572,39,611
20200413,KY,1963,23903,97,25866,3,1176,123,1299
20200413,LA,21016,87075,884,108091,44,3625,421,4046
20200413,MA,26794,95500,1211,122294,155,4037,1413,5450
20200413,MD,8936,42815,262,51751,27,1276,711,1987
20200413,ME,698,11608,19,12306,0,5520,65,5585
20200413,MI,25635,57009,1602,82644,115,2210,997,3207
20200413,MN,1650,36777,70,38427,0,977,29,1006
20200413,MO,4388,41040,114,45428,4,0,228,228
20200413,MP,11,27,2,47,0,0,0,0
20200413,MS,2942,28042,98,30984,2,9410,161,9571
20200413,MT,394,8704,7,9098,1,178,7,185
20200413,NC,4816,58572,86,63388,5,953,296,1249
20200413,ND,331,10450,8,10781,0,408,23,431
20200413,NE,814,10158,17,10972,0,258,23,281
20200413,NH,985,10222,23,11332,0,226,56,282
20200413,NJ,64584,64885,2443,129469,93,0,2734,2734
20200413,NM,1245,29270,26,30515,6,1752,71,1823
20200413,NV,2971,22493,114,25464,2,718,135,853
20200413,NY,195031,283326,10056,478357,671,10419,6337,16756
20200413,OH,6975,58137,274,65112,21,1498,371,1869
20200413,OK,2069,20790,99,22859,3,0,99,99
20200413,OR,1584,29537,53,31121,1,1306,57,1363
20200413,PA,24199,105593,524,129792,17,3536,1366,4902
20200413,PR,903,5960,45,8151,1,141,6,147
20200413,RI,2976,17685,73,20661,10,0,311,311
20200413,SC,3319,28106,82,31425,0,0,0,0
20200413,SD,868,8134,6,9002,0,311,138,449
20200413,TN,5610,70585,109,76195,8,5216,302,5518
20200413,TX,13906,119320,287,133226,16,8271,422,8693
20200413,UT,2363,43424,18,45787,0,1493,60,1553
20200413,VA,5747,35654,149,41874,8,943,473,1416
20200413,VI,51,322,1,375,0,23,0,23
20200413,VT,748,9618,28,10366,1,504,21,525
20200413,WA,10941,124124,526,135065,17,3778,355,4133
20200413,WI,3428,36769,154,40470,10,853,87,940
20200413,WV,626,16029,9,16655,1,383,15,398
20200413,WY,275,5689,1,5964,1,491,14,505
20200412,AK,272,7766,8,8038,0,291,15,306
20200412,AL,3525,18058,93,21583,2,0,334,334
20200412,AR,1280,18442,27,19722,3,1090,54,1144
20200412,AS,0,3,,5,0,0,0,0
20200412,AZ,3539,38570,115,42109,7,1433,146,1579
20200412,CA,21794,168534,651,203528,42,15930,1179,17109
20200412,CO,6893,27980,274,34873,24,1837,383,2220
20200412,CT,12035,29185,554,41220,60,864,525,1389
20200412,DC,1875,8765,50,10640,3,504,97,601
20200412,DE,1479,9624,33,11103,0,0,0,0
20200412,FL,19355,163398,465,184050,27,8959,861,9820
20200412,GA,12452,42001,433,54453,5,2445,293,2738
20200412,GU,133,693,5,826,0,0,0,0
20200412,HI,486,17482,8,17968,0,416,21,437
20200412,IA,1587,16005,41,17592,7,383,77,460
20200412,ID,1407,12901,27,14308,2,533,11,544
20200412,IL,20852,79883,720,100735,43,6914,1672,8586
20200412,IN,7928,34561,343,42489,13,2781,493,3274
20200412,KS,1337,11916,56,13253,1,841,69,910
20200412,KY,1840,22727,94,24567,4,132,147,279
20200412,LA,20595,83450,840,104045,34,6549,581,7130
20200412,MA,25381,91463,1056,116844,110,5348,2615,7963
20200412,MD,8225,41539,235,49764,29,1995,531,2526
20200412,ME,633,6088,19,6721,0,0,17,17
20200412,MI,24638,54799,1487,79437,95,2778,645,3423
20200412,MN,1621,35800,70,37421,6,1823,194,2017
20200412,MO,4160,41040,110,45200,1,1892,136,2028
20200412,MP,11,27,2,47,0,0,0,0
20200412,MS,2781,18632,96,21413,3,0,139,139
20200412,MT,387,8526,6,8913,0,322,10,332
20200412,NC,4520,57619,81,62139,1,1538,208,1746
20200412,ND,308,10042,8,10350,1,255,15,270
20200412,NE,791,9900,17,10691,0,615,91,706
20200412,NH,929,9996,23,11044,1,388,44,432
20200412,NJ,61850,64885,2350,126735,167,2843,3699,6542
20200412,NM,1174,27518,20,28692,1,1511,83,1594
20200412,NV,2836,21775,112,24611,10,888,136,1024
20200412,NY,188694,272907,9385,461601,758,12385,8236,20621
20200412,OH,6604,56639,253,63243,6,2418,354,2772
20200412,OK,1970,20790,96,22760,2,0,102,102
20200412,OR,1527,28231,52,29758,4,2378,156,2534
20200412,PA,22833,102057,507,124890,13,3559,1178,4737
20200412,PR,897,5819,44,7967,2,236,109,345
20200412,RI,2665,17685,63,20350,7,1827,316,2143
20200412,SC,3319,28106,82,31425,2,1220,112,1332
20200412,SD,730,7823,6,8553,0,445,104,549
20200412,TN,5308,65369,101,70677,0,3655,194,3849
20200412,TX,13484,111049,271,124533,17,3077,923,4000
20200412,UT,2303,41931,18,44234,0,1591,97,1688
20200412,VA,5274,34711,141,40506,11,1789,197,1986
20200412,VI,51,299,1,370,0,0,0,0
20200412,VT,727,9114,27,9841,2,567,16,583
20200412,WA,10586,120346,509,130932,15,1341,84,1425
20200412,WI,3341,35916,144,39257,7,1236,128,1364
20200412,WV,611,15646,8,16257,3,771,34,805
20200412,WY,261,5198,0,5459,0,0,0,0
20200411,AK,257,7475,8,7732,1,289,11,300
20200411,AL,3191,18058,91,21249,11,0,223,223
20200411,AR,1226,17352,24,18578,1,1403,55,1458
20200411,AS,0,3,,5,0,0,0,0
20200411,AZ,3393,37137,108,40530,11,2515,281,2796
20200411,CA,20615,152604,609,186419,68,7213,1143,8356
20200411,CO,6510,26143,250,32653,0,0,0,0
20200411,CT,11510,28321,494,39831,46,2571,972,3543
20200411,DC,1778,8261,47,10039,9,566,118,684
20200411,DE,1479,9624,33,11103,10,-791,153,-638
20200411,FL,18494,154439,438,174351,48,9140,963,10103
20200411,GA,12159,39556,428,51715,12,4892,676,5568
20200411,GU,133,693,5,826,1,31,3,34
20200411,HI,465,17066,8,17531,2,1359,23,1382
20200411,IA,1510,15622,34,17132,3,1057,122,1179
20200411,ID,1396,12368,25,13764,1,627,43,670
20200411,IL,19180,72969,677,92149,81,3329,1293,4622
20200411,IN,7435,31780,330,39215,30,3647,528,4175
20200411,KS,1268,11075,55,12343,5,827,102,929
20200411,KY,1693,22595,90,24288,0,0,0,0
20200411,LA,20014,76901,806,96915,51,3874,761,4635
20200411,MA,22766,86115,946,108881,114,4551,1888,6439
20200411,MD,7694,39544,206,47238,35,2064,726,2790
20200411,ME,616,6088,19,6704,2,0,30,30
20200411,MI,23993,52021,1392,76014,111,2760,1210,3970
20200411,MN,1427,33977,64,35404,7,1419,91,1510
20200411,MO,4024,39148,109,43172,13,2207,225,2432
20200411,MP,11,27,2,47,0,0,0,0
20200411,MS,2642,18632,93,21274,11,0,173,173
20200411,MT,377,8204,6,8581,0,272,12,284
20200411,NC,4312,56081,80,60393,6,2344,404,2748
20200411,ND,293,9787,7,10080,1,457,15,472
20200411,NE,700,9285,17,9985,2,566,65,631
20200411,NH,885,9608,22,10586,1,469,66,535
20200411,NJ,58151,62042,2183,120193,251,3107,3563,6670
20200411,NM,1091,26007,19,27098,0,0,0,0
20200411,NV,2700,20887,102,23587,16,722,116,838
20200411,NY,180458,260522,8627,440980,783,13149,9946,23095
20200411,OH,6250,54221,247,60471,16,1526,372,1898
20200411,OK,1868,20790,94,22658,6,420,74,494
20200411,OR,1371,25853,48,27224,4,1547,50,1597
20200411,PA,21655,98498,494,120153,78,5458,1676,7134
20200411,PR,788,5583,42,7703,3,462,63,525
20200411,RI,2349,15858,56,18207,7,3577,334,3911
20200411,SC,3207,26886,80,30093,8,1768,142,1910
20200411,SD,626,7378,6,8006,0,267,90,357
20200411,TN,5114,61714,101,66828,3,3777,252,4029
20200411,TX,12561,107972,254,120533,28,3925,890,4815
20200411,UT,2206,40340,18,42546,1,1680,104,1784
20200411,VA,5077,32922,130,38516,9,1972,568,2540
20200411,VI,51,299,1,370,0,26,1,27
20200411,VT,711,8547,25,9258,1,994,32,1026
20200411,WA,10502,119005,494,129507,18,1887,154,2041
20200411,WI,3213,34680,137,37893,9,1455,145,1600
20200411,WV,577,14875,5,15452,0,874,23,897
20200411,WY,261,5198,0,5459,0,462,8,470
20200410,AK,246,7186,7,7432,0,198,11,209
20200410,AL,2968,18058,80,21026,6,0,199,199
20200410,AR,1171,15949,23,17120,2,2117,52,2169
20200410,AS,0,3,0,5,0,0,0,0
20200410,AZ,3112,34622,97,37734,8,462,94,556
20200410,CA,19472,145391,541,178763,49,200,1163,1363
20200410,CO,6510,26143,250,32653,57,2599,855,3454
20200410,CT,10538,25750,448,36288,68,2032,754,2786
20200410,DC,1660,7695,38,9355,6,494,137,631
20200410,DE,1326,10415,23,11741,0,1732,119,1851
20200410,FL,17531,145299,390,164241,36,9114,1167,10281
20200410,GA,11483,34664,416,46147,37,4145,917,5062
20200410,GU,130,662,4,792,0,69,2,71
20200410,HI,442,15707,6,16149,1,391,7,398
20200410,IA,1388,14565,31,15953,2,862,118,980
20200410,ID,1353,11741,24,13094,6,442,121,563
20200410,IL,17887,69640,596,87527,68,5205,1465,6670
20200410,IN,6907,28133,300,35040,55,2351,556,2907
20200410,KS,1166,10248,50,11414,8,579,60,639
20200410,KY,1693,22595,90,24288,17,2140,347,2487
20200410,LA,19253,73027,755,92280,53,4391,970,5361
20200410,MA,20878,81564,832,102442,107,5418,2035,7453
20200410,MD,6968,37480,171,44448,33,2136,783,2919
20200410,ME,586,6088,17,6674,1,0,26,26
20200410,MI,22783,49261,1281,72044,205,3711,1279,4990
20200410,MN,1336,32558,57,33894,7,1506,94,1600
20200410,MO,3799,36941,96,40740,19,1986,260,2246
20200410,MP,11,27,2,47,0,0,0,0
20200410,MS,2469,18632,82,21101,6,0,209,209
20200410,MT,365,7932,6,8297,0,426,11,437
20200410,NC,3908,53737,74,57645,9,9579,257,9836
20200410,ND,278,9330,6,9608,1,609,9,618
20200410,NE,635,8719,15,9354,1,603,68,671
20200410,NH,819,9139,21,10113,3,376,31,407
20200410,NJ,54588,58935,1932,113523,232,2770,3561,6331
20200410,NM,1091,26007,19,27098,3,3065,226,3291
20200410,NV,2584,20165,86,22749,6,850,128,978
20200410,NY,170512,247373,7844,417885,777,15761,10575,26336
20200410,OH,5878,52695,231,58573,18,2222,366,2588
20200410,OK,1794,20370,88,22164,8,1775,110,1885
20200410,OR,1321,24306,44,25627,0,0,0,0
20200410,PA,19979,93040,416,113019,78,5666,1751,7417
20200410,PR,725,5121,39,7238,6,418,42,460
20200410,RI,2015,12281,49,14296,6,1599,288,1887
20200410,SC,3065,25118,72,28183,5,543,273,816
20200410,SD,536,7111,6,7647,0,411,89,500
20200410,TN,4862,57937,98,62799,4,2722,228,2950
20200410,TX,11671,104047,226,115718,27,8143,1441,9584
20200410,UT,2102,38660,17,40762,4,2263,126,2389
20200410,VA,4509,30950,121,35980,12,1966,467,2433
20200410,VI,50,273,1,368,0,22,4,26
20200410,VT,679,7553,24,8232,1,0,51,51
20200410,WA,10348,117118,476,127466,17,3936,301,4237
20200410,WI,3068,33225,128,36293,17,1801,183,1984
20200410,WV,554,14001,5,14555,0,661,31,692
20200410,WY,253,4736,0,4989,0,816,23,839
20200409,AK,235,6988,7,7223,0,146,9,155
20200409,AL,2769,18058,74,20827,8,1305,400,1705
20200409,AR,1119,13832,21,14951,3,302,119,421
20200409,AS,0,3,0,5,0,0,0,0
20200409,AZ,3018,34160,89,37178,9,2322,292,2614
20200409,CA,18309,145191,492,177600,50,17884,1352,19236
20200409,CO,5655,23544,193,29199,14,879,226,1105
20200409,CT,9784,23718,380,33502,103,2463,2003,4466
20200409,DC,1523,7201,32,8724,5,358,83,441
20200409,DE,1207,8683,23,9890,7,1055,279,1334
20200409,FL,16364,136185,354,153944,45,8506,909,9415
20200409,GA,10566,30519,379,41085,17,1633,665,2298
20200409,GU,128,593,4,721,0,31,3,34
20200409,HI,435,15316,5,15751,0,577,25,602
20200409,IA,1270,13703,29,14973,2,882,125,1007
20200409,ID,1232,11299,18,12531,3,611,22,633
20200409,IL,16422,64435,528,80857,66,4447,1344,5791
20200409,IN,6351,25782,245,32133,42,856,408,1264
20200409,KS,1106,9669,42,10775,4,532,60,592
20200409,KY,1346,20455,73,21801,8,0,197,197
20200409,LA,18283,68636,702,86919,50,4260,1253,5513
20200409,MA,18843,76146,725,94989,110,5297,2151,7448
20200409,MD,6185,35344,138,41529,14,2411,656,3067
20200409,ME,560,6088,16,6648,2,0,23,23
20200409,MI,21504,45550,1076,67054,117,0,915,915
20200409,MN,1242,31052,50,32294,11,1453,88,1541
20200409,MO,3539,34955,77,38494,19,4172,212,4384
20200409,MP,11,27,2,47,0,0,0,0
20200409,MS,2260,18632,76,20892,9,0,257,257
20200409,MT,354,7506,6,7860,0,440,22,462
20200409,NC,3651,44158,65,47809,12,4597,225,4822
20200409,ND,269,8721,5,8990,1,420,18,438
20200409,NE,567,8116,14,8683,2,674,48,722
20200409,NH,788,8763,18,9694,0,374,0,374
20200409,NJ,51027,56165,1700,107192,196,3186,3590,6776
20200409,NM,865,22942,16,23807,3,1491,71,1562
20200409,NV,2456,19315,80,21771,9,1067,138,1205
20200409,NY,159937,231612,7067,391549,799,15775,10621,26396
20200409,OH,5512,50473,213,55985,20,2280,364,2644
20200409,OK,1684,18595,80,20279,1,6774,160,6934
20200409,OR,1321,24306,44,25627,11,981,82,1063
20200409,PA,18228,87374,338,105602,29,5075,1989,7064
20200409,PR,683,4703,33,6690,9,437,63,500
20200409,RI,1727,10682,43,12409,8,0,277,277
20200409,SC,2792,24575,67,27367,4,2493,240,2733
20200409,SD,447,6700,6,7147,0,345,54,399
20200409,TN,4634,55215,94,59849,15,2959,272,3231
20200409,TX,10230,95904,199,106134,22,8999,877,9876
20200409,UT,1976,36397,13,38373,0,2127,130,2257
20200409,VA,4042,28984,109,33653,34,1984,397,2381
20200409,VI,46,251,1,339,0,9,1,10
20200409,VT,628,7553,23,8181,0,409,23,432
20200409,WA,10047,113182,459,123229,16,3832,362,4194
20200409,WI,2885,31424,111,34309,12,1309,129,1438
20200409,WV,523,13340,5,13863,1,1257,61,1318
20200409,WY,230,3920,0,4150,0,77,9,86
20200408,AK,226,6842,7,7068,1,142,13,155
20200408,AL,2369,16753,66,19122,10,3956,250,4206
20200408,AR,1000,13530,18,14530,2,838,54,892
20200408,AS,0,3,0,5,0,0,0,0
20200408,AZ,2726,31838,80,34564,7,1038,151,1189
20200408,CA,16957,127307,442,158864,68,11943,1092,13035
20200408,CO,5429,22665,179,28094,29,962,257,1219
20200408,CT,7781,21255,277,29036,0,0,0,0
20200408,DC,1440,6843,27,8283,5,231,229,460
20200408,DE,928,7628,16,8556,0,0,0,0
20200408,FL,15455,127679,309,144458,13,4264,708,4972
20200408,GA,9901,28886,362,38787,33,3991,1083,5074
20200408,GU,125,562,4,687,0,33,4,37
20200408,HI,410,14739,5,15149,0,1584,23,1607
20200408,IA,1145,12821,27,13966,1,1151,97,1248
20200408,ID,1210,10688,15,11898,2,612,40,652
20200408,IL,15078,59988,462,75066,82,4805,1529,6334
20200408,IN,5943,24926,203,30869,30,1669,436,2105
20200408,KS,1046,9137,38,10183,11,523,146,669
20200408,KY,1149,20455,65,21604,6,1508,141,1649
20200408,LA,17030,64376,652,81406,70,6005,746,6751
20200408,MA,16692,70849,615,87541,100,4579,1588,6167
20200408,MD,5529,32933,124,38462,21,5677,1158,6835
20200408,ME,537,6088,14,6625,2,0,18,18
20200408,MI,20589,45550,959,66139,114,0,766,766
20200408,MN,1154,29599,39,30753,5,1408,85,1493
20200408,MO,3327,30783,58,34110,5,1851,290,2141
20200408,MP,11,27,2,47,0,12,3,15
20200408,MS,2003,18632,67,20635,8,0,88,88
20200408,MT,332,7066,6,7398,0,400,13,413
20200408,NC,3426,39561,53,42987,7,1700,205,1905
20200408,ND,251,8301,4,8552,0,835,14,849
20200408,NE,519,7442,12,7961,2,631,72,703
20200408,NH,788,8389,18,9266,9,370,73,443
20200408,NJ,47437,52979,1504,100416,272,2421,3021,5442
20200408,NM,794,21451,13,22245,1,312,108,420
20200408,NV,2318,18248,71,20566,13,1696,231,1927
20200408,NY,149316,215837,6268,365153,779,14642,10453,25095
20200408,OH,5148,48193,193,53341,26,2137,366,2503
20200408,OK,1524,11821,79,13345,12,0,52,52
20200408,OR,1239,23325,33,24564,0,1499,58,1557
20200408,PA,16239,82299,309,98538,69,5580,1680,7260
20200408,PR,620,4266,24,6046,1,300,47,347
20200408,RI,1450,10682,35,12132,5,1605,220,1825
20200408,SC,2552,22082,63,24634,12,819,135,954
20200408,SD,393,6355,6,6748,0,407,73,480
20200408,TN,4362,52256,79,56618,7,3520,224,3744
20200408,TX,9353,86905,177,96258,23,6518,1091,7609
20200408,UT,1846,34270,13,36116,0,1361,108,1469
20200408,VA,3645,27000,75,30645,12,1688,312,2000
20200408,VI,45,242,1,322,0,20,2,22
20200408,VT,605,7144,23,7749,0,590,30,620
20200408,WA,9685,109350,443,119035,14,4388,341,4729
20200408,WI,2756,30115,99,32871,7,1603,178,1781
20200408,WV,462,12083,4,12545,0,436,50,486
20200408,WY,221,3843,0,4064,0,54,5,59
20200407,AK,213,6700,6,6913,0,8,22,30
20200407,AL,2119,12797,56,14916,6,0,151,151
20200407,AR,946,12692,16,13638,0,722,71,793
20200407,AS,0,3,0,5,0,0,0,0
20200407,AZ,2575,30800,73,33375,8,722,119,841
20200407,CA,15865,115364,374,145329,31,12269,1529,13798
20200407,CO,5172,21703,150,26875,10,880,222,1102
20200407,CT,7781,21255,277,29036,71,1475,875,2350
20200407,DC,1211,6612,22,7823,-2,256,114,370
20200407,DE,928,7628,16,8556,2,1307,255,1562
20200407,FL,14747,123415,296,139569,60,13465,1423,14888
20200407,GA,8818,24895,329,33713,100,935,1504,2439
20200407,GU,121,529,4,650,0,24,8,32
20200407,HI,387,13155,5,13542,1,0,16,16
20200407,IA,1048,11670,26,12718,1,1017,102,1119
20200407,ID,1170,10076,13,11246,3,182,69,251
20200407,IL,13549,55183,380,68732,73,4503,1287,5790
20200407,IN,5507,23257,173,28764,34,2010,563,2573
20200407,KS,900,8614,27,9514,2,375,55,430
20200407,KY,1008,18947,59,19955,14,1135,53,1188
20200407,LA,16284,58371,582,74655,70,4072,1417,5489
20200407,MA,15104,66270,515,81374,67,3550,1365,4915
20200407,MD,4371,27256,103,31627,12,1684,326,2010
20200407,ME,519,6088,12,6607,2,0,20,20
20200407,MI,19823,45550,845,65373,118,2430,973,3403
20200407,MN,1069,28191,34,29260,4,1049,83,1132
20200407,MO,3037,28932,53,31969,14,1819,315,2134
20200407,MP,8,15,2,23,1,2,0,2
20200407,MS,1915,18632,59,20547,8,0,177,177
20200407,MT,319,6666,6,6985,0,175,20,195
20200407,NC,3221,37861,46,41082,13,5,351,356
20200407,ND,237,7466,4,7703,1,478,12,490
20200407,NE,447,6811,10,7258,2,433,38,471
20200407,NH,715,8019,9,8783,0,318,46,364
20200407,NJ,44416,50558,1232,94974,229,2616,3326,5942
20200407,NM,686,21139,12,21825,0,2627,62,2689
20200407,NV,2087,16552,58,18639,12,876,134,1010
20200407,NY,138863,201195,5489,340058,731,11073,8174,19247
20200407,OH,4782,46056,167,50838,25,2128,332,2460
20200407,OK,1472,11821,67,13293,16,10399,145,10544
20200407,OR,1181,21826,33,23007,6,1157,49,1206
20200407,PA,14559,76719,240,91278,78,5845,1579,7424
20200407,PR,573,3966,23,5507,2,534,60,594
20200407,RI,1230,9077,30,10307,3,1678,148,1826
20200407,SC,2417,21263,51,23680,7,4336,368,4704
20200407,SD,320,5948,6,6270,2,216,32,248
20200407,TN,4138,48736,72,52874,7,5188,336,5524
20200407,TX,8262,80387,154,88649,14,2306,986,3292
20200407,UT,1738,32909,13,34647,0,1190,63,1253
20200407,VA,3333,25312,63,28645,9,3669,455,4124
20200407,VI,43,222,1,285,0,0,0,0
20200407,VT,575,6554,23,7129,0,464,32,496
20200407,WA,9344,104962,429,114306,22,4742,409,5151
20200407,WI,2578,28512,92,31090,15,1938,138,2076
20200407,WV,412,11647,4,12059,0,2052,67,2119
20200407,WY,216,3789,0,4005,0,70,6,76
20200406,AK,191,6692,6,6883,0,593,6,599
20200406,AL,1968,12797,50,14765,5,1515,172,1687
20200406,AR,875,11970,16,12845,0,1558,45,1603
20200406,AS,0,3,0,5,0,0,0,0
20200406,AZ,2456,30078,65,32534,1,4937,187,5124
20200406,CA,14336,103095,343,132431,24,0,898,898
20200406,CO,4950,20823,140,25773,14,1488,385,1873
20200406,CT,6906,19780,206,26686,17,2185,1231,3416
20200406,DC,1097,6356,24,7453,2,520,99,619
20200406,DE,673,6321,14,6994,0,0,0,0
20200406,FL,13324,109950,236,124416,18,8697,1173,9870
20200406,GA,7314,23960,229,31274,18,2775,667,3442
20200406,GU,113,505,4,618,0,12,1,13
20200406,HI,371,13155,4,13526,0,551,20,571
20200406,IA,946,10653,25,11599,3,680,78,758
20200406,ID,1101,9894,10,10995,0,710,24,734
20200406,IL,12262,50680,307,62942,33,2953,1006,3959
20200406,IN,4944,21247,139,26191,12,3006,533,3539
20200406,KS,845,8239,25,9084,3,763,98,861
20200406,KY,955,17812,45,18767,5,2066,38,2104
20200406,LA,14867,54299,512,69166,35,6984,1857,8841
20200406,MA,13739,62720,448,76459,78,3155,1337,4492
20200406,MD,4045,25572,91,29617,24,844,436,1280
20200406,ME,499,6088,10,6587,0,0,29,29
20200406,MI,18850,43120,727,61970,110,2789,1283,4072
20200406,MN,986,27142,30,28128,1,1300,51,1351
20200406,MO,2722,27113,39,29835,5,2231,355,2586
20200406,MP,8,13,1,31,0,0,0,0
20200406,MS,1738,18632,51,20370,8,13052,100,13152
20200406,MT,299,6491,6,6790,0,174,13,187
20200406,NC,2870,37856,33,40726,2,396,285,681
20200406,ND,225,6988,3,7213,0,408,18,426
20200406,NE,409,6378,8,6795,0,820,46,866
20200406,NH,669,7701,9,8471,0,290,48,338
20200406,NJ,41090,47942,1003,89032,86,3281,3585,6866
20200406,NM,624,18512,12,19136,1,2227,81,2308
20200406,NV,1953,15676,46,17629,0,681,117,798
20200406,NY,130689,190122,4758,320811,599,9873,8658,18531
20200406,OH,4450,43928,142,48378,23,4215,407,4622
20200406,OK,1327,1422,51,2749,5,21,75,96
20200406,OR,1132,20669,27,21801,0,1113,64,1177
20200406,PA,12980,70874,162,83854,12,4613,1470,6083
20200406,PR,513,3432,21,4945,1,359,38,397
20200406,RI,1082,7399,27,8481,2,1140,160,1300
20200406,SC,2049,16927,44,18976,0,0,0,0
20200406,SD,288,5732,4,6020,2,379,48,427
20200406,TN,3802,43548,65,47350,21,1881,169,2050
20200406,TX,7276,78081,140,85357,13,13955,464,14419
20200406,UT,1675,31719,13,33394,5,2432,70,2502
20200406,VA,2878,21643,54,24521,3,609,241,850
20200406,VI,43,222,1,285,0,16,1,17
20200406,VT,543,6090,23,6633,1,20,31,51
20200406,WA,8935,100220,407,109155,21,4656,393,5049
20200406,WI,2440,26574,77,29014,9,1405,173,1578
20200406,WV,345,9595,4,9940,1,1081,21,1102
20200406,WY,210,3719,0,3929,0,679,13,692
20200405,AK,185,6099,6,6284,1,230,14,244
20200405,AL,1796,11282,45,13078,2,2009,216,2225
20200405,AR,830,10412,16,11242,2,785,87,872
20200405,AS,0,3,0,5,0,0,0,0
20200405,AZ,2269,25141,64,27410,12,0,250,250
20200405,CA,13438,103095,319,131533,43,1421,1412,2833
20200405,CO,4565,19335,126,23900,15,1437,392,1829
20200405,CT,5675,17595,189,23270,24,842,399,1241
20200405,DC,998,5836,22,6834,1,300,96,396
20200405,DE,673,6321,14,6994,0,447,80,527
20200405,FL,12151,101253,218,114533,27,10297,1040,11337
20200405,GA,6647,21185,211,27832,10,1051,487,1538
20200405,GU,112,493,4,605,0,21,19,40
20200405,HI,351,12604,4,12955,1,645,32,677
20200405,IA,868,9973,22,10841,8,519,82,601
20200405,ID,1077,9184,10,10261,0,1327,64,1391
20200405,IL,11256,47727,274,58983,31,4503,899,5402
20200405,IN,4411,18241,127,22652,11,2394,458,2852
20200405,KS,747,7476,22,8223,1,596,49,645
20200405,KY,917,15746,40,16663,3,1005,86,1091
20200405,LA,13010,47315,477,60325,68,1313,514,1827
20200405,MA,12402,59565,370,71967,66,2374,765,3139
20200405,MD,3609,24728,67,28337,14,2243,484,2727
20200405,ME,470,6088,10,6558,0,0,14,14
20200405,MI,17567,40331,617,57898,77,2926,1172,4098
20200405,MN,935,25842,29,26777,5,1284,70,1354
20200405,MO,2367,24882,34,27249,10,2268,76,2344
20200405,MP,8,13,1,31,0,0,0,0
20200405,MS,1638,5580,43,7218,8,447,183,630
20200405,MT,286,6317,6,6603,1,405,21,426
20200405,NC,2585,37460,31,40045,7,1089,183,1272
20200405,ND,207,6580,3,6787,0,559,21,580
20200405,NE,363,5558,8,5933,2,500,42,542
20200405,NH,621,7411,9,8125,2,446,81,527
20200405,NJ,37505,44661,917,82166,71,3429,3381,6810
20200405,NM,543,16285,11,16828,1,1148,48,1196
20200405,NV,1836,14995,46,16831,0,574,94,668
20200405,NY,122031,180249,4159,302280,594,10332,8327,18659
20200405,OH,4043,39713,119,43756,17,1581,304,1885
20200405,OK,1252,1401,46,2653,4,39,93,132
20200405,OR,1068,19556,27,20624,1,3021,69,3090
20200405,PA,11510,66261,150,77771,14,6248,1493,7741
20200405,PR,475,3073,20,4587,2,468,23,491
20200405,RI,922,6259,25,7181,8,675,116,791
20200405,SC,2049,16927,44,18976,4,530,132,662
20200405,SD,240,5353,2,5593,0,341,28,369
20200405,TN,3633,41667,44,45300,1,3597,312,3909
20200405,TX,6812,64126,127,70938,22,6485,702,7187
20200405,UT,1605,29287,8,30892,0,2672,177,2849
20200405,VA,2637,21034,51,23671,-1,1889,230,2119
20200405,VI,42,206,1,266,1,22,2,24
20200405,VT,512,6070,22,6582,2,687,51,738
20200405,WA,8542,95564,386,104106,21,1774,169,1943
20200405,WI,2267,25169,68,27436,12,1310,155,1465
20200405,WV,324,8514,3,8838,1,1110,42,1152
20200405,WY,197,3040,0,3237,0,95,10,105
20200404,AK,171,5869,5,6040,2,10,14,24
20200404,AL,1580,9273,43,10853,8,1086,148,1234
20200404,AR,743,9627,14,10370,2,632,39,671
20200404,AS,0,3,0,5,0,0,0,0
20200404,AZ,2019,25141,52,27160,11,2237,250,2487
20200404,CA,12026,101674,276,126700,39,77075,1325,78400
20200404,CO,4173,17898,111,22071,14,1215,445,1660
20200404,CT,5276,16753,165,22029,34,1652,362,2014
20200404,DC,902,5536,21,6438,6,709,145,854
20200404,DE,593,5874,14,6467,0,879,143,1022
20200404,FL,11111,90956,191,103348,28,8819,1526,10345
20200404,GA,6160,20134,201,26294,17,700,329,1029
20200404,GU,93,472,4,565,0,13,9,22
20200404,HI,319,11959,3,12278,1,1753,34,1787
20200404,IA,786,9454,14,10240,3,700,87,787
20200404,ID,1013,7857,10,8870,1,803,122,925
20200404,IL,10357,43224,243,53581,33,4080,1453,5533
20200404,IN,3953,15847,116,19800,14,1449,516,1965
20200404,KS,698,6880,21,7578,4,426,78,504
20200404,KY,831,14741,37,15572,6,2707,61,2768
20200404,LA,12496,46002,409,58498,39,2654,2199,4853
20200404,MA,11637,57191,304,68828,39,4506,1334,5840
20200404,MD,3125,22485,53,25610,11,1553,367,1920
20200404,ME,456,6088,10,6544,1,0,24,24
20200404,MI,16395,37405,540,53800,61,3735,1143,4878
20200404,MN,865,24558,24,25423,2,1120,76,1196
20200404,MO,2291,22614,24,24905,5,3257,178,3435
20200404,MP,8,13,1,31,0,0,0,0
20200404,MS,1455,5133,35,6588,6,380,97,477
20200404,MT,265,5912,5,6177,0,579,22,601
20200404,NC,2402,36371,24,38773,5,6866,309,7175
20200404,ND,186,6021,3,6207,0,396,13,409
20200404,NE,321,5058,6,5389,0,571,42,613
20200404,NH,540,6965,7,7599,2,390,61,451
20200404,NJ,34124,41232,846,75356,200,3624,4229,7853
20200404,NM,495,15137,10,15632,3,762,92,854
20200404,NV,1742,14421,46,16163,3,1403,228,1631
20200404,NY,113704,169917,3565,283621,630,12260,10841,23101
20200404,OH,3739,38132,102,41871,11,3069,427,3496
20200404,OK,1159,1362,42,2521,4,47,171,218
20200404,OR,999,16535,26,17534,4,0,100,100
20200404,PA,10017,60013,136,70030,34,6318,1597,7915
20200404,PR,452,2605,18,4186,3,556,74,630
20200404,RI,806,5584,17,6390,3,727,97,824
20200404,SC,1917,16397,40,18314,9,10956,363,11319
20200404,SD,212,5012,2,5225,0,419,25,444
20200404,TN,3321,38070,43,41391,6,3298,254,3552
20200404,TX,6110,57641,105,63751,15,7207,780,7987
20200404,UT,1428,26615,8,28043,1,3613,182,3795
20200404,VA,2407,19145,52,21552,6,2152,395,2547
20200404,VI,40,184,,266,0,30,2,32
20200404,VT,461,5383,20,5844,3,544,72,616
20200404,WA,8373,93790,365,102163,27,2374,208,2582
20200404,WI,2112,23859,56,25971,19,1482,200,1682
20200404,WV,282,7404,2,7686,0,1274,45,1319
20200404,WY,187,2945,0,3132,0,241,25,266
20200403,AK,157,5859,3,6016,0,980,14,994
20200403,AL,1432,8187,35,9619,3,684,199,883
20200403,AR,704,8995,12,9699,0,1115,61,1176
20200403,AS,0,3,0,5,0,0,0,0
20200403,AZ,1769,22904,41,24673,9,1793,171,1964
20200403,CA,10701,24599,237,94800,34,790,1510,2300
20200403,CO,3728,16683,97,20411,17,1380,386,1766
20200403,CT,4914,15101,131,20015,19,625,1090,1715
20200403,DC,757,4827,15,5584,3,410,104,514
20200403,DE,450,4995,14,5445,2,429,57,486
20200403,FL,9585,82137,163,92947,35,12851,1575,14426
20200403,GA,5831,19434,184,25265,21,1825,483,2308
20200403,GU,84,459,4,543,1,17,2,19
20200403,HI,285,10206,2,10491,1,0,27,27
20200403,IA,699,8754,11,9453,0,700,85,785
20200403,ID,891,7054,9,7945,0,441,222,663
20200403,IL,8904,39144,210,48048,53,3183,1209,4392
20200403,IN,3437,14398,102,17835,24,1152,398,1550
20200403,KS,620,6454,17,7074,4,395,68,463
20200403,KY,770,12034,31,12804,11,4814,90,4904
20200403,LA,10297,43348,370,53645,60,1412,1147,2559
20200403,MA,10303,52685,265,62988,36,4918,1436,6354
20200403,MD,2758,20932,42,23690,6,2042,427,2469
20200403,ME,432,6088,9,6520,2,0,56,56
20200403,MI,15252,33670,479,48922,62,3302,1135,4437
20200403,MN,789,23438,22,24227,4,1786,47,1833
20200403,MO,2113,19357,19,21470,0,1508,279,1787
20200403,MP,8,13,1,31,0,0,0,0
20200403,MS,1358,4753,29,6111,3,0,181,181
20200403,MT,243,5333,5,5576,0,240,16,256
20200403,NC,2093,29505,19,31598,3,2683,236,2919
20200403,ND,173,5625,3,5798,0,804,14,818
20200403,NE,279,4487,6,4777,1,509,33,542
20200403,NH,479,6575,5,7168,1,497,64,561
20200403,NJ,29895,37608,646,67503,109,4088,4305,8393
20200403,NM,403,14375,7,14778,1,727,40,767
20200403,NV,1514,13018,43,14532,5,430,56,486
20200403,NY,102863,157657,2935,260520,562,11073,10482,21555
20200403,OH,3312,35063,91,38375,10,3047,410,3457
20200403,OK,988,1315,38,2303,4,50,109,159
20200403,OR,899,16535,22,17434,1,1276,73,1349
20200403,PA,8420,53695,102,62115,12,5997,1404,7401
20200403,PR,378,2049,15,3482,3,445,62,507
20200403,RI,709,4857,14,5566,2,445,52,497
20200403,SC,1554,5441,31,6995,0,0,0,0
20200403,SD,187,4593,2,4783,0,376,22,398
20200403,TN,3067,34772,37,37839,5,3006,222,3228
20200403,TX,5330,50434,90,55764,20,4424,661,5085
20200403,UT,1246,23002,7,24248,0,2847,172,3019
20200403,VA,2012,16993,46,19005,5,1110,306,1416
20200403,VI,38,154,,248,0,5,5,10
20200403,VT,389,4839,17,5228,0,128,51,179
20200403,WA,8165,91416,338,99581,28,4361,409,4770
20200403,WI,1912,22377,37,24289,6,2060,182,2242
20200403,WV,237,6130,2,6367,0,854,20,874
20200403,WY,162,2704,0,2866,0,265,12,277
20200402,AK,143,4879,3,5022,0,409,10,419
20200402,AL,1233,7503,32,8736,6,806,156,962
20200402,AR,643,7880,12,8523,2,526,59,585
20200402,AS,0,3,0,5,0,0,0,0
20200402,AZ,1598,21111,32,22709,3,1466,185,1651
20200402,CA,9191,23809,203,92500,32,2037,1036,3073
20200402,CO,3342,15303,80,18645,11,1420,376,1796
20200402,CT,3824,14476,112,18300,27,1433,267,1700
20200402,DC,653,4417,12,5070,1,1155,67,1222
20200402,DE,393,4566,12,4959,1,551,25,576
20200402,FL,8010,69286,128,78581,41,9757,1055,10812
20200402,GA,5348,17609,163,22957,24,1921,710,2631
20200402,GU,82,442,3,524,0,36,5,41
20200402,HI,258,10206,1,10464,0,1485,50,1535
20200402,IA,614,8054,11,8668,2,750,65,815
20200402,ID,669,6613,9,7282,0,537,144,681
20200402,IL,7695,35961,157,43656,16,2557,715,3272
20200402,IN,3039,13246,78,16285,13,1436,474,1910
20200402,KS,552,6059,13,6611,3,648,70,718
20200402,KY,680,7220,20,7900,3,255,89,344
20200402,LA,9150,41936,310,51086,37,2584,2726,5310
20200402,MA,8867,47767,229,56634,42,3642,1228,4870
20200402,MD,2331,18890,36,21221,5,1657,346,2003
20200402,ME,376,6088,7,6464,0,0,32,32
20200402,MI,14117,30368,417,44485,80,3131,1229,4360
20200402,MN,742,21652,18,22394,1,1150,53,1203
20200402,MO,1834,17849,19,19683,1,2003,253,2256
20200402,MP,8,13,1,33,1,13,2,15
20200402,MS,1177,4753,26,5930,4,1041,104,1145
20200402,MT,227,5093,5,5320,0,383,19,402
20200402,NC,1857,26822,16,28679,6,2163,273,2436
20200402,ND,159,4821,3,4980,0,470,17,487
20200402,NE,246,3978,5,4235,1,503,36,539
20200402,NH,415,6078,4,6619,0,93,0,93
20200402,NJ,25590,33520,537,59110,182,3133,3335,6468
20200402,NM,363,13648,6,14011,1,723,48,771
20200402,NV,1458,12588,38,14046,12,1069,179,1248
20200402,NY,92381,146584,2373,238965,432,9416,8669,18085
20200402,OH,2902,32016,81,34918,16,5024,355,5379
20200402,OK,879,1265,34,2144,4,17,160,177
20200402,OR,826,15259,21,16085,3,2123,90,2213
20200402,PA,7016,47698,90,54714,16,5271,1211,6482
20200402,PR,316,1604,12,3039,1,195,30,225
20200402,RI,657,4412,12,5069,2,581,91,672
20200402,SC,1554,5441,31,6995,5,408,261,669
20200402,SD,165,4217,2,4382,0,314,36,350
20200402,TN,2845,31766,32,34611,8,1997,162,2159
20200402,TX,4669,46010,70,50679,12,2150,672,2822
20200402,UT,1074,20155,7,21229,0,0,62,62
20200402,VA,1706,15883,41,17589,7,2023,222,2245
20200402,VI,33,149,,224,0,23,3,26
20200402,VT,338,4711,17,5049,1,537,17,554
20200402,WA,7756,87055,310,94811,28,4424,403,4827
20200402,WI,1730,20317,31,22047,7,1498,180,1678
20200402,WV,217,5276,2,5493,1,892,26,918
20200402,WY,150,2439,0,2589,0,221,20,241
20200401,AK,133,4470,3,4603,0,876,14,890
20200401,AL,1077,6697,26,7774,13,399,96,495
20200401,AR,584,7354,10,7938,2,1395,61,1456
20200401,AS,0,3,0,5,0,0,0,0
20200401,AZ,1413,19645,29,21058,5,1563,124,1687
20200401,CA,8155,21772,171,87327,18,0,673,673
20200401,CO,2966,13883,69,16849,18,1146,339,1485
20200401,CT,3557,13043,85,16600,16,14,429,443
20200401,DC,586,3262,11,3850,2,0,91,91
20200401,DE,368,4015,11,4383,1,319,49,368
20200401,FL,6955,59529,87,67719,10,5244,617,5861
20200401,GA,4638,15688,139,20326,28,3436,709,4145
20200401,GU,77,406,3,483,1,35,8,43
20200401,HI,208,8721,1,8929,1,250,4,254
20200401,IA,549,7304,9,7853,2,416,52,468
20200401,ID,525,6076,9,6601,2,779,110,889
20200401,IL,6980,33404,141,40384,42,4173,986,5159
20200401,IN,2565,11810,65,14375,16,596,406,1002
20200401,KS,482,5411,10,5893,1,415,54,469
20200401,KY,591,6965,17,7556,6,635,111,746
20200401,LA,6424,39352,273,45776,34,5622,1187,6809
20200401,MA,7639,44125,187,51764,34,3685,1118,4803
20200401,MD,1985,17233,31,19218,13,2365,325,2690
20200401,ME,344,6088,7,6432,2,0,41,41
20200401,MI,12888,27237,337,40125,78,3258,1013,4271
20200401,MN,689,20502,17,21191,5,1351,60,1411
20200401,MO,1581,15846,18,17427,4,1232,254,1486
20200401,MP,6,,,6,0,0,4,4
20200401,MS,1073,3712,22,4785,2,175,136,311
20200401,MT,208,4710,5,4918,1,476,24,500
20200401,NC,1584,24659,10,26243,2,3051,86,3137
20200401,ND,142,4351,3,4493,0,220,16,236
20200401,NE,210,3475,4,3693,1,544,38,582
20200401,NH,415,5985,4,6497,1,572,101,673
20200401,NJ,22255,30387,355,52642,88,3310,3559,6869
20200401,NM,315,12925,5,13240,1,679,34,713
20200401,NV,1279,11519,26,12798,9,838,166,1004
20200401,NY,83712,137168,1941,220880,391,7777,7917,15694
20200401,OH,2547,26992,65,29539,10,0,348,348
20200401,OK,719,1248,30,1967,7,19,154,173
20200401,OR,736,13136,18,13872,0,0,46,46
20200401,PA,5805,42427,74,48232,11,4782,962,5744
20200401,PR,286,1409,11,2592,3,214,47,261
20200401,RI,566,3831,10,4397,2,355,77,432
20200401,SC,1293,5033,26,6326,4,417,210,627
20200401,SD,129,3903,2,4032,1,294,21,315
20200401,TN,2683,29769,24,32452,1,4648,444,5092
20200401,TX,3997,43860,58,47857,17,4134,731,4865
20200401,UT,1012,20155,7,21167,2,2529,125,2654
20200401,VA,1484,13860,34,15344,7,1709,234,1943
20200401,VI,30,126,,180,0,0,0,0
20200401,VT,321,4174,16,4495,3,217,28,245
20200401,WA,7353,82631,282,89984,20,4212,446,4658
20200401,WI,1550,18819,24,20369,8,1444,199,1643
20200401,WV,191,4384,1,4575,0,403,29,432
20200401,WY,130,2218,0,2348,0,219,21,240
20200331,AK,119,3594,3,3713,0,54,5,59
20200331,AL,981,6298,13,7279,7,604,122,726
20200331,AR,523,5959,8,6482,1,697,50,747
20200331,AS,0,3,0,5,0,3,0,3
20200331,AZ,1289,18082,24,19371,4,2480,132,2612
20200331,CA,7482,21772,153,86654,20,1223,1035,2258
20200331,CO,2627,12737,51,15364,0,0,0,0
20200331,CT,3128,13029,69,16157,33,1000,557,1557
20200331,DC,495,3262,9,3759,0,580,94,674
20200331,DE,319,3696,10,4015,4,1480,55,1535
20200331,FL,6338,54285,77,61786,14,6060,865,6925
20200331,GA,3929,12252,111,16181,24,2337,1120,3457
20200331,GU,69,371,2,440,1,19,11,30
20200331,HI,204,8471,,8675,0,646,29,675
20200331,IA,497,6888,7,7385,1,726,73,799
20200331,ID,415,5297,7,5712,1,901,105,1006
20200331,IL,5994,29231,99,35225,26,3842,937,4779
20200331,IN,2159,11214,49,13373,14,1342,373,1715
20200331,KS,428,4996,9,5424,1,442,60,502
20200331,KY,480,6330,11,6810,2,751,41,792
20200331,LA,5237,33730,239,38967,54,3722,1212,4934
20200331,MA,6521,40440,153,46961,29,3274,868,4142
20200331,MD,1660,14868,18,16528,3,1552,247,1799
20200331,ME,303,6088,5,6391,2,2694,28,2722
20200331,MI,11875,23979,259,35854,75,2796,974,3770
20200331,MN,629,19151,12,19780,2,905,53,958
20200331,MO,1327,14614,14,15941,1,1410,296,1706
20200331,MP,2,,,2,0,0,0,0
20200331,MS,937,3537,20,4474,4,548,90,638
20200331,MT,184,4234,4,4418,0,91,13,104
20200331,NC,1498,21608,8,23106,2,2051,191,2242
20200331,ND,126,4131,3,4257,1,403,17,420
20200331,NE,172,2931,3,3111,1,347,27,374
20200331,NH,314,5413,3,5792,0,27,0,27
20200331,NJ,18696,27077,267,45773,69,1853,2060,3913
20200331,NM,281,12246,4,12527,2,1304,44,1348
20200331,NV,1113,10681,17,11794,2,474,105,579
20200331,NY,75795,129391,1550,205186,332,9420,9298,18718
20200331,OH,2199,26992,55,29191,16,1650,266,1916
20200331,OK,565,1229,23,1794,6,22,84,106
20200331,OR,690,13136,18,13826,2,859,84,943
20200331,PA,4843,37645,63,42488,14,3868,756,4624
20200331,PR,239,1195,8,2288,2,264,65,329
20200331,RI,489,3476,8,3965,4,289,87,376
20200331,SC,1083,4616,22,5699,4,456,158,614
20200331,SD,108,3609,1,3717,0,131,7,138
20200331,TN,2239,25121,23,27360,10,3651,405,4056
20200331,TX,3266,39726,41,42992,7,6723,389,7112
20200331,UT,887,17626,5,18513,1,2429,81,2510
20200331,VA,1250,12151,27,13401,2,1133,230,1363
20200331,VI,30,126,,180,0,0,0,0
20200331,VT,293,3957,13,4250,1,283,37,320
20200331,WA,6907,78419,262,85326,14,4159,467,4626
20200331,WI,1351,17375,16,18726,2,1519,130,1649
20200331,WV,162,3981,1,4143,0,997,36,1033
20200331,WY,109,1999,0,2108,0,159,15,174
20200330,AK,114,3540,3,3654,1,308,12,320
20200330,AL,859,5694,6,6553,2,1510,53,1563
20200330,AR,473,5262,7,5735,1,2235,47,2282
20200330,AS,,,0,0,0,0,0,0
20200330,AZ,1157,15602,20,16759,3,2649,238,2887
20200330,CA,6447,20549,133,91396,10,0,739,739
20200330,CO,2627,12737,51,15364,7,1522,566,2088
20200330,CT,2571,12029,36,14600,2,2122,578,2700
20200330,DC,401,2682,9,3085,4,213,59,272
20200330,DE,264,2216,6,2480,0,2180,32,2212
20200330,FL,5473,48225,63,53698,7,9155,1227,10382
20200330,GA,2809,9915,87,12724,7,2,158,160
20200330,GU,58,352,1,410,0,18,2,20
20200330,HI,175,7825,,8000,0,976,24,1000
20200330,IA,424,6162,6,6586,2,1149,88,1237
20200330,ID,310,4396,6,4706,1,375,49,424
20200330,IL,5057,25389,73,30446,8,2223,461,2684
20200330,IN,1786,9872,35,11658,3,1556,272,1828
20200330,KS,368,4554,8,4922,2,360,49,409
20200330,KY,439,5579,9,6018,0,432,45,477
20200330,LA,4025,30008,185,34033,34,5677,485,6162
20200330,MA,5653,37166,124,42819,25,2932,797,3729
20200330,MD,1413,13316,15,14729,5,962,174,1136
20200330,ME,275,3394,3,3669,0,0,22,22
20200330,MI,10901,21183,184,32084,52,5507,891,6398
20200330,MN,576,18246,10,18822,1,1092,73,1165
20200330,MO,1031,13204,13,14235,3,1657,193,1850
20200330,MP,2,,,2,0,0,0,0
20200330,MS,847,2989,16,3836,2,429,89,518
20200330,MT,171,4143,4,4314,3,0,17,17
20200330,NC,1307,19557,6,20864,2,1652,267,1919
20200330,ND,109,3728,2,3837,1,373,11,384
20200330,NE,145,2584,2,2734,0,616,37,653
20200330,NH,314,5386,3,5844,1,862,100,962
20200330,NJ,16636,25224,198,41860,37,3008,3250,6258
20200330,NM,237,10942,2,11179,0,173,0,173
20200330,NV,1008,10207,15,11215,1,1795,270,2065
20200330,NY,66497,119971,1218,186468,253,7124,6984,14108
20200330,OH,1933,25342,39,27275,10,6330,280,6610
20200330,OK,481,1207,17,1688,1,2,52,54
20200330,OR,606,12277,16,12883,3,1399,58,1457
20200330,PA,4087,33777,49,37864,11,3716,693,4409
20200330,PR,174,931,6,1899,1,90,47,137
20200330,RI,402,3187,4,3589,1,347,108,455
20200330,SC,925,4160,18,5085,2,1145,151,1296
20200330,SD,101,3478,1,3579,0,351,11,362
20200330,TN,1834,21470,13,23304,6,2433,297,2730
20200330,TX,2877,33003,34,35880,0,9795,325,10120
20200330,UT,806,15197,4,16003,2,1923,87,2010
20200330,VA,1020,11018,25,12038,3,1299,130,1429
20200330,VI,30,126,,180,0,3,7,10
20200330,VT,256,3674,12,3930,0,208,21,229
20200330,WA,6440,74260,248,80700,11,4496,561,5057
20200330,WI,1221,15856,14,17077,1,-694,109,-585
20200330,WV,126,2984,1,3110,1,279,13,292
20200330,WY,94,1840,0,1934,0,286,8,294
20200329,AK,102,3232,2,3334,0,396,17,413
20200329,AL,806,4184,4,4990,1,0,110,110
20200329,AR,426,3027,6,3453,1,89,22,111
20200329,AS,,,0,0,0,0,0,0
20200329,AZ,919,12953,17,13872,2,5498,46,5544
20200329,CA,5708,20549,123,90657,22,0,1065,1065
20200329,CO,2061,11215,44,13276,13,1273,327,1600
20200329,CT,1993,9907,34,11900,7,2798,702,3500
20200329,DC,342,2469,5,2812,1,258,38,296
20200329,DE,232,36,6,268,3,0,18,18
20200329,FL,4246,39070,56,43316,2,3704,483,4187
20200329,GA,2651,9913,80,12564,11,1228,285,1513
20200329,GU,56,334,1,390,0,35,1,36
20200329,HI,151,6849,,7000,0,2492,31,2523
20200329,IA,336,5013,4,5349,1,638,38,676
20200329,ID,261,4021,5,4282,1,679,31,710
20200329,IL,4596,23166,65,27762,18,1166,1105,2271
20200329,IN,1514,8316,32,9830,1,1141,282,1423
20200329,KS,319,4194,6,4513,1,523,58,581
20200329,KY,394,5147,9,5541,1,326,92,418
20200329,LA,3540,24331,151,27871,14,2485,225,2710
20200329,MA,4856,34234,99,39090,27,3319,698,4017
20200329,MD,1239,12354,10,13593,5,838,247,1085
20200329,ME,253,3394,3,3647,2,0,42,42
20200329,MI,10010,15676,132,25686,40,1493,723,2216
20200329,MN,503,17154,9,17657,4,1466,62,1528
20200329,MO,838,11547,10,12385,0,1465,0,1465
20200329,MP,2,,,2,0,0,0,0
20200329,MS,758,2560,14,3318,1,0,95,95
20200329,MT,154,4143,1,4297,0,887,25,912
20200329,NC,1040,17905,4,18945,0,1313,105,1418
20200329,ND,98,3355,1,3453,0,546,15,561
20200329,NE,108,1968,2,2080,0,64,12,76
20200329,NH,214,4524,2,5023,0,868,27,895
20200329,NJ,13386,22216,161,35602,21,2830,2262,5092
20200329,NM,237,10769,2,11006,1,1573,46,1619
20200329,NV,738,8412,14,9150,4,511,117,628
20200329,NY,59513,112847,965,172360,237,9231,7195,16426
20200329,OH,1653,19012,29,20665,4,0,247,247
20200329,OK,429,1205,16,1634,1,25,52,77
20200329,OR,548,10878,13,11426,0,1185,69,1254
20200329,PA,3394,30061,38,33455,4,4807,643,5450
20200329,PR,127,841,5,1785,2,102,27,129
20200329,RI,294,2840,3,3134,3,299,55,354
20200329,SC,774,3015,16,3789,3,607,235,842
20200329,SD,90,3127,1,3218,0,535,22,557
20200329,TN,1537,19037,7,20574,1,2072,164,2236
20200329,TX,2552,23208,34,25760,7,0,500,500
20200329,UT,719,13274,2,13993,0,2564,117,2681
20200329,VA,890,9719,22,10609,5,1292,151,1443
20200329,VI,23,123,,183,0,17,1,18
20200329,VT,235,3466,12,3701,0,1303,24,1327
20200329,WA,5879,69764,237,75643,17,1588,238,1826
20200329,WI,1112,16550,13,17662,0,1318,123,1441
20200329,WV,113,2705,0,2818,0,374,17,391
20200329,WY,86,1554,0,1640,0,79,4,83
20200328,AK,85,2836,2,2921,1,517,16,533
20200328,AL,696,4184,3,4880,0,0,109,109
20200328,AR,404,2938,5,3342,2,1393,23,1416
20200328,AS,,,0,0,0,0,0,0
20200328,AZ,873,7455,15,8349,2,0,137,137
20200328,CA,4643,20549,101,89592,23,3169,764,3933
20200328,CO,1734,9942,31,11676,7,1250,304,1554
20200328,CT,1291,7109,27,8400,0,0,0,0
20200328,DC,304,2211,4,2516,1,314,37,351
20200328,DE,214,36,3,250,1,0,51,51
20200328,FL,3763,35366,54,39129,20,7180,998,8178
20200328,GA,2366,8685,69,11051,5,821,365,1186
20200328,GU,55,299,1,354,0,0,4,4
20200328,HI,120,4357,,4477,0,0,14,14
20200328,IA,298,4375,3,4673,0,635,63,698
20200328,ID,230,3342,4,3572,1,674,41,715
20200328,IL,3491,22000,47,25491,13,3484,465,3949
20200328,IN,1232,7175,31,8407,7,1220,251,1471
20200328,KS,261,3671,5,3932,1,442,59,501
20200328,KY,302,4821,8,5123,2,1053,54,1107
20200328,LA,3315,21846,137,25161,18,3233,569,3802
20200328,MA,4158,30915,72,35073,15,4671,1007,5678
20200328,MD,992,11516,5,12508,0,11422,218,11640
20200328,ME,211,3394,1,3605,0,0,43,43
20200328,MI,9287,14183,92,23470,0,1544,628,2172
20200328,MN,441,15688,5,16129,1,2083,43,2126
20200328,MO,838,10082,10,10920,2,9713,169,9882
20200328,MP,2,,,2,0,0,2,2
20200328,MS,663,2560,13,3223,5,0,84,84
20200328,MT,129,3256,1,3385,1,666,21,687
20200328,NC,935,16592,4,17527,1,2219,172,2391
20200328,ND,83,2809,1,2892,1,382,18,400
20200328,NE,96,1904,2,2000,2,143,11,154
20200328,NH,187,3656,2,4139,1,261,29,290
20200328,NJ,11124,19386,140,30510,32,2839,2299,5138
20200328,NM,191,9196,1,9387,0,819,55,874
20200328,NV,621,7901,10,8522,0,1740,86,1826
20200328,NY,52318,103616,728,155934,209,2498,7683,10181
20200328,OH,1406,19012,25,20418,6,0,269,269
20200328,OK,377,1180,15,1557,7,96,55,151
20200328,OR,479,9693,13,10172,1,1183,65,1248
20200328,PA,2751,25254,34,28005,12,4238,533,4771
20200328,PR,100,739,3,1631,0,220,21,241
20200328,RI,239,2541,,2918,0,235,36,271
20200328,SC,539,2408,13,2947,4,101,83,184
20200328,SD,68,2592,1,2660,0,205,10,215
20200328,TN,1373,16965,6,18338,0,2077,170,2247
20200328,TX,2052,23208,27,25260,4,1273,321,1594
20200328,UT,602,10710,2,11312,0,1946,122,2068
20200328,VA,739,8427,17,9166,3,1694,135,1829
20200328,VI,22,106,,183,0,51,3,54
20200328,VT,211,2163,12,2374,2,86,27,113
20200328,WA,5641,68176,220,73817,21,2319,283,2602
20200328,WI,989,15232,13,16221,0,2092,147,2239
20200328,WV,96,2331,0,2433,0,552,20,572
20200328,WY,82,1475,0,1557,0,264,12,276
20200327,AK,69,2319,1,2401,0,518,10,528
20200327,AL,587,4184,3,4771,2,591,81,672
20200327,AR,381,1545,3,1926,0,41,46,87
20200327,AS,,,0,0,0,0,0,0
20200327,AZ,736,7455,13,8221,5,7108,159,7267
20200327,CA,3879,17380,78,78659,13,0,873,873
20200327,CO,1430,8692,24,10122,5,1714,344,2058
20200327,CT,1291,7109,27,8400,6,1484,279,1763
20200327,DC,267,1897,3,2166,0,271,36,307
20200327,DE,163,36,2,199,1,0,33,33
20200327,FL,2765,28186,34,32468,6,4445,410,4855
20200327,GA,2001,7864,64,9865,16,463,476,939
20200327,GU,51,299,1,350,0,36,6,42
20200327,HI,106,4357,,4463,0,0,11,11
20200327,IA,235,3740,3,3975,2,1162,56,1218
20200327,ID,189,2668,3,2857,3,603,66,669
20200327,IL,3026,18516,34,21542,8,4423,488,4911
20200327,IN,981,5955,24,6936,7,1949,336,2285
20200327,KS,202,3229,4,3431,1,360,34,394
20200327,KY,248,3768,6,4016,2,666,50,716
20200327,LA,2746,18613,119,21359,36,2889,441,3330
20200327,MA,3151,26244,57,29395,15,4917,833,5750
20200327,MD,774,94,5,868,1,0,194,194
20200327,ME,168,3394,1,3562,1,0,13,13
20200327,MI,8659,12639,92,21298,32,2334,892,3226
20200327,MN,398,13605,4,14003,2,1001,52,1053
20200327,MO,669,369,8,1038,0,0,167,167
20200327,MP,0,,0,0,0,0,0,0
20200327,MS,579,2560,8,3139,2,269,94,363
20200327,MT,108,2590,,2698,0,462,37,499
20200327,NC,763,14373,3,15136,1,2099,127,2226
20200327,ND,65,2427,0,2492,0,388,13,401
20200327,NE,85,1761,0,1846,0,177,12,189
20200327,NH,158,3395,1,4145,0,394,21,415
20200327,NJ,8825,16547,108,25372,27,2886,1949,4835
20200327,NM,136,8377,1,8513,0,696,24,720
20200327,NV,535,6161,10,6696,0,1464,115,1579
20200327,NY,44635,101118,519,145753,134,16272,7377,23649
20200327,OH,1137,19012,19,20149,4,2563,270,2833
20200327,OK,322,1084,8,1406,1,126,74,200
20200327,OR,414,8510,12,8924,1,1557,87,1644
20200327,PA,2218,21016,22,23234,6,4575,531,5106
20200327,PR,79,519,3,932,1,142,15,157
20200327,RI,203,2306,,2647,0,1044,38,1082
20200327,SC,456,2307,9,2763,0,0,0,0
20200327,SD,58,2387,1,2465,0,414,12,426
20200327,TN,1203,14888,6,16091,3,936,246,1182
20200327,TX,1731,21935,23,23666,5,1907,335,2242
20200327,UT,480,8764,2,9244,1,1456,78,1534
20200327,VA,604,6733,14,7337,1,1004,144,1148
20200327,VI,19,55,,76,0,0,2,2
20200327,VT,184,2077,10,2261,1,227,26,253
20200327,WA,5358,65857,199,71215,16,3902,449,4351
20200327,WI,842,13140,13,13982,5,1557,135,1692
20200327,WV,76,1779,0,1898,0,748,25,773
20200327,WY,70,1211,0,1281,0,159,17,176
20200326,AK,59,1801,1,1860,0,152,17,169
20200326,AL,506,3593,1,4099,1,1064,223,1287
20200326,AR,335,1504,3,1839,1,67,55,122
20200326,AS,,,0,0,0,0,0,0
20200326,AZ,577,347,8,957,2,24,127,151
20200326,CA,3006,17380,65,77786,12,1459,651,2110
20200326,CO,1086,6978,19,8064,8,189,174,363
20200326,CT,1012,5625,21,6637,2,602,137,739
20200326,DC,231,1626,3,1858,1,203,48,251
20200326,DE,130,36,1,166,1,0,15,15
20200326,FL,2355,23741,28,27539,6,8367,673,9040
20200326,GA,1525,7401,48,8926,8,2469,278,2747
20200326,GU,45,263,1,308,0,30,8,38
20200326,HI,95,4357,,4452,0,0,5,5
20200326,IA,179,2578,1,2757,0,0,34,34
20200326,ID,123,2065,0,2188,0,178,50,228
20200326,IL,2538,14093,26,16631,7,1749,673,2422
20200326,IN,645,4006,17,4651,3,1127,168,1295
20200326,KS,168,2869,3,3037,0,509,42,551
20200326,KY,198,3102,4,3300,0,237,41,278
20200326,LA,2305,15724,83,18029,18,6068,510,6578
20200326,MA,2318,21327,42,23645,9,3248,579,3827
20200326,MD,580,94,4,674,0,0,157,157
20200326,ME,155,3394,,3549,0,217,6,223
20200326,MI,7767,10305,60,18072,17,2768,707,3475
20200326,MN,346,12604,2,12950,1,1416,59,1475
20200326,MO,502,369,8,871,0,0,146,146
20200326,MP,0,,0,0,0,0,0,0
20200326,MS,485,2291,6,2776,4,725,108,833
20200326,MT,71,2128,,2199,0,180,18,198
20200326,NC,636,12274,2,12910,1,2289,132,2421
20200326,ND,52,2039,0,2091,0,305,13,318
20200326,NE,73,1584,0,1657,0,280,12,292
20200326,NH,137,3001,1,3850,0,645,29,674
20200326,NJ,6876,13661,81,20537,19,3209,2474,5683
20200326,NM,112,7681,1,7793,0,939,12,951
20200326,NV,420,4697,10,5117,4,446,99,545
20200326,NY,37258,84846,385,122104,100,12178,6447,18625
20200326,OH,867,16449,15,17316,5,2389,163,2552
20200326,OK,248,958,7,1206,2,153,84,237
20200326,OR,327,6953,11,7280,3,2603,118,2721
20200326,PA,1687,16441,16,18128,5,5248,560,5808
20200326,PR,64,377,2,776,0,60,13,73
20200326,RI,165,1262,,1608,0,0,33,33
20200326,SC,456,2307,9,2763,2,4,32,36
20200326,SD,46,1973,1,2144,0,1154,5,1159
20200326,TN,957,13952,3,14909,0,2940,173,3113
20200326,TX,1396,20028,18,21424,6,7508,422,7930
20200326,UT,402,7308,1,7710,0,817,56,873
20200326,VA,460,5729,13,6189,4,750,69,819
20200326,VI,17,55,,74,0,0,0,0
20200326,VT,158,1850,9,2008,1,261,35,296
20200326,WA,4909,61955,183,66864,24,4049,432,4481
20200326,WI,707,11583,8,12290,1,1494,122,1616
20200326,WV,51,1031,0,1101,0,272,12,284
20200326,WY,53,1052,,1105,0,98,9,107
20200325,AK,42,1649,1,1691,1,663,6,669
20200325,AL,283,2529,0,2812,0,423,68,491
20200325,AR,280,1437,2,1717,2,490,62,552
20200325,AS,,,0,0,0,0,0,0
20200325,AZ,450,323,6,826,1,10,93,103
20200325,CA,2355,15921,53,66876,13,2469,253,2722
20200325,CO,912,6789,11,7701,4,1285,192,1477
20200325,CT,875,5023,19,5898,7,341,257,598
20200325,DC,183,1423,2,1609,0,228,46,274
20200325,DE,115,36,0,151,0,0,24,24
20200325,FL,1682,15374,22,18289,4,2247,270,2517
20200325,GA,1247,4932,40,6179,8,474,221,695
20200325,GU,37,233,1,270,0,32,5,37
20200325,HI,90,4357,,4447,0,768,13,781
20200325,IA,145,2578,1,2723,1,263,21,284
20200325,ID,73,1887,0,1960,0,0,23,23
20200325,IL,1865,12344,19,14209,3,2410,330,2740
20200325,IN,477,2879,14,3356,2,313,112,425
20200325,KS,126,2360,3,2486,1,274,28,302
20200325,KY,157,2865,4,3022,0,1103,33,1136
20200325,LA,1795,9656,65,11451,19,2441,407,2848
20200325,MA,1739,18079,33,19818,7,5365,679,6044
20200325,MD,423,94,4,517,1,0,74,74
20200325,ME,149,3177,,3326,0,163,24,187
20200325,MI,7060,7537,43,14597,19,1741,619,2360
20200325,MN,287,11188,1,11475,0,5638,25,5663
20200325,MO,356,369,8,725,5,0,173,173
20200325,MP,0,,0,0,0,0,0,0
20200325,MS,377,1566,2,1943,1,14,57,71
20200325,MT,53,1948,,2001,0,305,7,312
20200325,NC,504,9985,1,10489,1,1844,106,1950
20200325,ND,39,1734,0,1773,0,280,5,285
20200325,NE,61,1304,0,1365,0,329,9,338
20200325,NH,108,2356,1,3268,0,909,7,916
20200325,NJ,4402,10452,62,14854,18,2127,727,2854
20200325,NM,100,6742,1,6842,1,852,17,869
20200325,NV,321,4251,6,4572,2,297,43,340
20200325,NY,30811,72668,285,103479,75,7063,5146,12209
20200325,OH,704,14060,10,14764,2,13920,140,14060
20200325,OK,164,805,5,969,2,70,58,128
20200325,OR,209,4350,8,4559,0,0,0,0
20200325,PA,1127,11193,11,12320,4,2550,276,2826
20200325,PR,51,317,2,438,0,49,12,61
20200325,RI,132,1262,,1590,0,62,8,70
20200325,SC,424,2303,7,2727,2,291,126,417
20200325,SD,41,819,1,1128,0,29,11,40
20200325,TN,784,11012,3,11796,1,495,117,612
20200325,TX,974,12520,12,13494,3,1763,564,2327
20200325,UT,346,6491,1,6837,0,967,47,1014
20200325,VA,391,4979,9,5370,2,799,101,900
20200325,VI,17,55,,74,0,55,0,55
20200325,VT,123,1589,8,1712,1,149,28,177
20200325,WA,4477,57906,159,62383,13,4572,439,5011
20200325,WI,585,10089,7,10674,2,1852,128,1980
20200325,WV,39,759,0,804,0,149,19,168
20200325,WY,44,954,,998,0,244,15,259
20200324,AK,36,986,0,1022,0,40,14,54
20200324,AL,215,2106,0,2321,0,441,48,489
20200324,AR,218,947,0,1165,0,41,44,85
20200324,AS,,,0,0,0,0,0,0
20200324,AZ,357,313,5,692,3,4,92,96
20200324,CA,2102,13452,40,27654,13,885,369,1254
20200324,CO,720,5504,7,6224,1,659,129,788
20200324,CT,618,4682,12,5300,2,597,203,800
20200324,DC,137,1195,2,1334,0,82,21,103
20200324,DE,91,36,0,127,0,0,23,23
20200324,FL,1412,13127,18,15547,4,2064,241,2305
20200324,GA,1026,4458,32,5484,7,161,254,415
20200324,GU,32,201,1,233,0,40,3,43
20200324,HI,77,3589,,3666,0,634,21,655
20200324,IA,124,2315,,2439,0,272,19,291
20200324,ID,50,1887,0,1937,0,578,3,581
20200324,IL,1535,9934,16,11469,4,1351,262,1613
20200324,IN,365,2566,12,2931,5,865,106,971
20200324,KS,98,2086,2,2184,0,1669,16,1685
20200324,KY,124,1762,4,1886,1,0,20,20
20200324,LA,1388,7215,46,8603,12,2439,216,2655
20200324,MA,1060,12714,26,13774,9,4451,382,4833
20200324,MD,349,94,3,443,0,0,61,61
20200324,ME,125,3014,,3139,0,223,18,241
20200324,MI,6441,5796,24,12237,9,1099,652,1751
20200324,MN,262,5550,1,5812,0,1039,27,1066
20200324,MO,183,369,3,552,0,0,0,0
20200324,MP,0,,0,0,0,0,0,0
20200324,MS,320,1552,1,1872,0,409,71,480
20200324,MT,46,1643,,1689,0,497,12,509
20200324,NC,398,8141,0,8539,0,0,101,101
20200324,ND,34,1454,0,1488,0,101,4,105
20200324,NE,52,975,0,1027,0,619,2,621
20200324,NH,101,1447,1,2417,1,73,23,96
20200324,NJ,3675,8325,44,12045,17,7966,831,8797
20200324,NM,83,5890,,5973,0,569,18,587
20200324,NV,278,3954,4,4232,0,464,33,497
20200324,NY,25665,65605,210,91270,96,8191,4790,12981
20200324,OH,564,140,8,704,2,0,122,122
20200324,OK,106,735,3,841,1,41,25,66
20200324,OR,209,4350,8,4559,3,701,18,719
20200324,PA,851,8643,7,9494,1,2048,207,2255
20200324,PR,39,268,2,349,0,79,8,87
20200324,RI,124,1200,,1401,0,57,18,75
20200324,SC,298,2012,5,2310,0,546,0,546
20200324,SD,30,790,1,1088,0,28,2,30
20200324,TN,667,10517,2,11184,0,7245,52,7297
20200324,TX,410,10757,9,11167,1,1054,58,1112
20200324,UT,299,5524,1,5823,0,734,42,776
20200324,VA,290,4180,7,4470,1,737,36,773
20200324,VI,17,,,17,0,0,0,0
20200324,VT,95,1440,7,1535,2,334,20,354
20200324,WA,4038,53334,146,57372,9,4818,434,5252
20200324,WI,457,8237,5,8694,0,1187,41,1228
20200324,WV,20,610,0,630,0,166,4,170
20200324,WY,29,710,,739,0,118,3,121
20200323,AK,22,946,0,968,0,0,0,0
20200323,AL,167,1665,0,1832,0,201,29,230
20200323,AR,174,906,0,1080,0,195,9,204
20200323,AS,,,0,0,0,0,0,0
20200323,AZ,265,309,2,580,0,27,113,140
20200323,CA,1733,12567,27,26400,0,1263,197,1460
20200323,CO,591,4845,6,5436,1,770,116,886
20200323,CT,415,4085,10,4500,5,1208,192,1400
20200323,DC,116,1113,2,1229,1,156,18,174
20200323,DE,68,36,0,104,0,0,12,12
20200323,FL,1171,11063,14,13094,1,3073,341,3414
20200323,GA,772,4297,25,5069,2,877,172,1049
20200323,GU,29,161,1,190,0,35,2,37
20200323,HI,56,2955,,3011,0,2692,8,2700
20200323,IA,105,2043,,2148,0,828,15,843
20200323,ID,47,1309,0,1356,0,134,5,139
20200323,IL,1273,8583,12,9856,3,1312,224,1536
20200323,IN,259,1701,7,1960,1,408,58,466
20200323,KS,82,417,2,499,0,0,18,18
20200323,KY,104,1762,3,1866,0,290,5,295
20200323,LA,1172,4776,34,5948,14,2115,335,2450
20200323,MA,678,8263,17,8941,6,2787,131,2918
20200323,MD,288,94,3,382,0,0,44,44
20200323,ME,107,2791,,2898,0,527,18,545
20200323,MI,5789,4697,15,10486,7,985,691,1676
20200323,MN,235,4511,1,4746,0,0,66,66
20200323,MO,183,369,3,552,0,0,93,93
20200323,MP,0,,0,0,0,0,0,0
20200323,MS,249,1143,1,1392,0,29,42,71
20200323,MT,34,1146,,1180,0,0,3,3
20200323,NC,297,8141,0,8438,0,1958,42,2000
20200323,ND,30,1353,0,1383,0,93,2,95
20200323,NE,50,356,0,406,0,0,2,2
20200323,NH,78,1374,,2341,0,186,13,199
20200323,NJ,2844,359,27,3297,7,32,930,962
20200323,NM,65,5321,,5386,0,599,8,607
20200323,NV,245,3490,4,3735,2,1042,55,1097
20200323,NY,20875,57414,114,78289,0,11181,5707,16888
20200323,OH,442,140,6,582,3,0,91,91
20200323,OK,81,694,2,877,0,25,14,39
20200323,OR,191,3649,5,3840,1,785,30,815
20200323,PA,644,6595,6,7239,4,1631,165,1796
20200323,PR,31,189,2,255,1,6,8,14
20200323,RI,106,1143,,1465,0,211,23,234
20200323,SC,298,1466,5,1764,2,0,103,103
20200323,SD,28,762,1,1055,0,22,7,29
20200323,TN,615,3272,2,3887,2,0,110,110
20200323,TX,352,9703,8,10055,3,1281,18,1299
20200323,UT,257,4790,1,5047,0,1282,76,1358
20200323,VA,254,3443,6,3697,3,325,35,360
20200323,VI,17,,,17,0,0,11,11
20200323,VT,75,1106,5,1181,3,0,23,23
20200323,WA,3604,48516,137,52120,11,4846,463,5309
20200323,WI,416,7050,5,7466,1,820,31,851
20200323,WV,16,444,0,464,0,59,4,63
20200323,WY,26,592,,618,0,154,2,156
20200322,AK,22,946,0,968,0,188,8,196
20200322,AL,138,1464,0,1602,0,1436,14,1450
20200322,AR,165,711,0,995,0,144,47,191
20200322,AS,,,0,0,0,0,0,0
20200322,AZ,152,282,2,521,1,42,48,90
20200322,CA,1536,11304,27,12840,3,55,257,312
20200322,CO,475,4075,5,4550,1,758,112,870
20200322,CT,223,2877,5,3100,1,771,29,800
20200322,DC,98,957,1,1055,0,451,21,472
20200322,DE,56,36,0,92,0,0,11,11
20200322,FL,830,7990,13,9783,1,1411,172,1583
20200322,GA,600,3420,23,4020,9,863,93,956
20200322,GU,27,126,1,153,1,18,12,30
20200322,HI,48,263,,311,0,139,11,150
20200322,IA,90,1215,,1305,0,166,22,188
20200322,ID,42,1175,0,1217,0,295,11,306
20200322,IL,1049,7271,9,8320,3,1783,296,2079
20200322,IN,201,1293,6,1494,2,586,75,661
20200322,KS,64,417,2,481,0,0,9,9
20200322,KY,99,1472,3,1571,1,758,45,803
20200322,LA,837,2661,20,3498,4,481,257,738
20200322,MA,547,5476,11,6023,4,677,121,798
20200322,MD,244,94,3,338,1,0,54,54
20200322,ME,89,2264,,2353,0,0,16,16
20200322,MI,5098,3712,8,8810,3,16,555,571
20200322,MN,169,4511,1,4680,0,559,31,590
20200322,MO,90,369,3,459,0,0,17,17
20200322,MP,0,,0,0,0,0,0,0
20200322,MS,207,1114,1,1321,0,419,67,486
20200322,MT,31,1146,,1177,0,0,11,11
20200322,NC,255,6183,0,6438,0,1091,71,1162
20200322,ND,28,1260,0,1288,0,119,0,119
20200322,NE,48,356,0,404,0,0,10,10
20200322,NH,65,1188,,2212,0,215,10,225
20200322,NJ,1914,327,20,2290,4,33,587,620
20200322,NM,57,4722,,4779,0,951,0,951
20200322,NV,190,2448,2,2638,0,64,66,130
20200322,NY,15168,46233,114,61401,70,11152,4812,15964
20200322,OH,351,140,3,491,0,0,104,104
20200322,OK,67,669,2,838,1,109,14,123
20200322,OR,161,2864,4,3025,1,861,47,908
20200322,PA,479,4964,2,5443,0,1198,108,1306
20200322,PR,23,183,1,275,1,40,2,42
20200322,RI,83,932,,1231,0,70,17,87
20200322,SC,195,1466,3,1661,2,211,43,254
20200322,SD,21,740,1,1038,0,49,7,56
20200322,TN,505,3272,,3777,0,0,134,134
20200322,TX,334,8422,5,8756,0,2204,30,2234
20200322,UT,181,3508,1,3689,1,1084,45,1129
20200322,VA,219,3118,3,3337,1,480,67,547
20200322,VI,6,,,6,0,0,0,0
20200322,VT,52,1106,2,1158,0,327,23,350
20200322,WA,3141,43670,126,46811,15,1708,183,1891
20200322,WI,385,6230,4,6615,0,1602,104,1706
20200322,WV,12,385,0,398,0,55,1,56
20200322,WY,24,438,,462,0,0,1,1
20200321,AK,14,758,0,772,0,72,2,74
20200321,AL,124,28,0,152,0,0,43,43
20200321,AR,118,567,,839,0,216,22,238
20200321,AS,,,0,0,0,0,0,0
20200321,AZ,104,240,1,466,1,29,39,68
20200321,CA,1279,11249,24,12528,4,825,216,1041
20200321,CO,363,3317,4,3680,1,642,86,728
20200321,CT,194,2106,4,2300,1,1502,0,1502
20200321,DC,77,506,1,583,0,5,6,11
20200321,DE,45,36,0,81,0,0,7,7
20200321,FL,658,6579,12,8239,2,4709,138,4847
20200321,GA,507,2557,14,3064,1,591,87,678
20200321,GU,15,108,,123,0,22,1,23
20200321,HI,37,124,,161,0,0,11,11
20200321,IA,68,1049,,1117,0,407,23,430
20200321,ID,31,880,,911,0,290,8,298
20200321,IL,753,5488,6,6241,1,1792,168,1960
20200321,IN,126,707,4,833,2,232,47,279
20200321,KS,55,417,2,472,1,0,11,11
20200321,KY,54,714,2,768,1,122,7,129
20200321,LA,580,2180,16,2760,4,1612,107,1719
20200321,MA,426,4799,7,5225,2,1004,112,1116
20200321,MD,190,94,2,284,1,0,41,41
20200321,ME,73,2264,,2337,0,0,16,16
20200321,MI,4543,3696,5,8239,2,950,516,1466
20200321,MN,138,3952,1,4090,1,211,23,234
20200321,MO,73,369,3,442,2,0,26,26
20200321,MP,0,,0,0,0,0,0,0
20200321,MS,140,695,1,835,0,0,60,60
20200321,MT,20,1146,,1166,0,215,4,219
20200321,NC,184,5092,0,5276,0,1996,47,2043
20200321,ND,28,1141,0,1169,0,341,8,349
20200321,NE,38,356,0,394,0,116,6,122
20200321,NH,55,973,,1970,0,228,11,239
20200321,NJ,1327,294,16,1661,5,30,437,467
20200321,NM,57,3771,,3828,0,0,14,14
20200321,NV,124,2384,2,2508,1,392,15,407
20200321,NY,10356,35081,44,45437,9,9756,3254,13010
20200321,OH,247,140,3,387,2,0,78,78
20200321,OK,53,560,1,757,0,22,4,26
20200321,OR,114,2003,3,2550,0,0,0,0
20200321,PA,371,3766,2,4137,1,1192,103,1295
20200321,PR,21,143,,235,0,29,7,36
20200321,RI,66,862,,1218,0,62,12,74
20200321,SC,152,1255,1,1407,0,422,71,493
20200321,SD,14,691,1,973,0,28,0,28
20200321,TN,371,3272,,3643,0,2709,143,2852
20200321,TX,304,6218,5,6522,0,1135,110,1245
20200321,UT,136,2424,0,2560,0,389,24,413
20200321,VA,152,2638,2,2790,0,427,38,465
20200321,VI,6,,,6,0,0,3,3
20200321,VT,29,779,2,808,0,0,0,0
20200321,WA,2958,41962,111,44920,7,2152,194,2346
20200321,WI,281,4628,4,4909,1,1173,75,1248
20200321,WV,11,330,0,343,0,111,4,115
20200321,WY,23,438,,461,0,107,4,111
20200320,AK,12,686,0,698,0,254,6,260
20200320,AL,81,28,0,109,0,0,13,13
20200320,AR,96,351,,650,0,41,50,91
20200320,AS,,,0,0,0,0,0,0
20200320,AZ,65,211,0,377,0,36,21,57
20200320,CA,1063,10424,20,11487,2,1637,139,1776
20200320,CO,277,2675,3,2952,1,563,61,624
20200320,CT,194,604,3,798,2,0,98,98
20200320,DC,71,501,1,573,1,348,32,380
20200320,DE,38,36,0,74,0,0,8,8
20200320,FL,520,1870,10,3416,2,337,130,467
20200320,GA,420,1966,13,2386,3,422,133,555
20200320,GU,14,86,,100,0,17,2,19
20200320,HI,26,124,,150,0,31,10,41
20200320,IA,45,642,,687,0,559,7,566
20200320,ID,23,590,,613,0,131,12,143
20200320,IL,585,3696,5,4281,1,971,163,1134
20200320,IN,79,475,2,554,0,151,23,174
20200320,KS,44,417,1,461,0,0,10,10
20200320,KY,47,592,1,639,0,138,12,150
20200320,LA,473,568,12,1041,4,110,126,236
20200320,MA,314,3795,5,4109,2,877,85,962
20200320,MD,149,94,1,243,0,0,42,42
20200320,ME,57,2264,,2321,0,260,4,264
20200320,MI,4027,2746,3,6773,0,961,635,1596
20200320,MN,115,3741,,3856,0,792,26,818
20200320,MO,47,369,1,416,0,61,23,84
20200320,MP,0,,0,0,0,0,0,0
20200320,MS,80,695,1,775,1,143,30,173
20200320,MT,16,931,,947,0,170,4,174
20200320,NC,137,3096,0,3233,0,688,40,728
20200320,ND,20,800,0,820,0,307,5,312
20200320,NE,32,240,0,272,0,0,5,5
20200320,NH,44,745,,1420,0,124,5,129
20200320,NJ,890,264,11,1240,2,54,148,202
20200320,NM,43,3771,,3814,0,1009,8,1017
20200320,NV,109,1992,1,2101,0,366,14,380
20200320,NY,7102,25325,35,32427,23,7193,2950,10143
20200320,OH,169,140,1,309,1,0,50,50
20200320,OK,49,538,1,961,0,72,5,77
20200320,OR,114,2003,3,2550,0,674,26,700
20200320,PA,268,2574,1,2842,0,966,83,1049
20200320,PR,14,114,,180,0,58,9,67
20200320,RI,54,800,,994,0,146,10,156
20200320,SC,81,833,1,914,0,250,21,271
20200320,SD,14,663,1,947,0,112,3,115
20200320,TN,228,563,,791,0,214,74,288
20200320,TX,194,5083,5,5277,2,2871,51,2922
20200320,UT,112,2035,0,2147,0,587,34,621
20200320,VA,114,2211,2,2325,0,382,20,402
20200320,VI,3,,,3,0,0,0,0
20200320,VT,29,779,2,808,2,134,7,141
20200320,WA,2764,39810,104,42574,12,3765,303,4068
20200320,WI,206,3455,3,3661,3,1263,51,1314
20200320,WV,7,219,0,239,0,76,5,81
20200320,WY,19,331,,350,0,60,1,61
20200319,AK,6,432,0,438,0,26,0,26
20200319,AL,68,28,0,96,0,0,22,22
20200319,AR,46,310,,469,0,74,13,87
20200319,AS,,,0,0,0,0,0,0
20200319,AZ,44,175,0,349,0,27,16,43
20200319,CA,924,8787,18,9711,5,806,313,1119
20200319,CO,216,2112,2,2328,0,495,33,528
20200319,CT,96,604,1,700,1,479,28,507
20200319,DC,39,153,0,203,0,15,8,23
20200319,DE,30,36,0,66,0,0,5,5
20200319,FL,390,1533,8,2942,1,308,76,384
20200319,GA,287,1544,10,1831,9,233,90,323
20200319,GU,12,69,,81,0,12,4,16
20200319,HI,16,93,,109,0,0,2,2
20200319,IA,38,83,,121,0,0,9,9
20200319,ID,11,459,,470,0,0,2,2
20200319,IL,422,2725,4,3147,3,962,134,1096
20200319,IN,56,324,2,380,0,170,17,187
20200319,KS,34,417,1,451,0,0,18,18
20200319,KY,35,454,1,489,0,100,9,109
20200319,LA,347,458,8,805,2,123,107,230
20200319,MA,229,2918,3,3147,1,803,73,876
20200319,MD,107,94,1,201,1,0,22,22
20200319,ME,53,2004,,2057,0,334,10,344
20200319,MI,3392,1785,3,5177,3,570,479,1049
20200319,MN,89,2949,,3038,0,264,12,276
20200319,MO,24,308,1,332,1,55,11,66
20200319,MP,0,,0,0,0,0,0,0
20200319,MS,50,552,,602,0,73,16,89
20200319,MT,12,761,,773,0,262,2,264
20200319,NC,97,2408,0,2505,0,621,34,655
20200319,ND,15,493,0,508,0,225,9,234
20200319,NE,27,240,0,267,0,34,3,37
20200319,NH,39,621,,891,0,108,13,121
20200319,NJ,742,210,9,1026,4,20,315,335
20200319,NM,35,2762,,2797,0,436,7,443
20200319,NV,95,1626,1,1721,0,1458,40,1498
20200319,NY,4152,18132,12,22284,0,5917,1770,7687
20200319,OH,119,140,,259,0,0,31,31
20200319,OK,44,466,1,760,1,88,15,103
20200319,OR,88,1329,3,1854,0,211,13,224
20200319,PA,185,1608,1,1793,0,421,52,473
20200319,PR,5,56,,90,0,25,0,25
20200319,RI,44,654,,1032,0,114,11,125
20200319,SC,60,583,1,643,0,0,0,0
20200319,SD,11,551,1,947,0,0,0,0
20200319,TN,154,349,,503,0,0,56,56
20200319,TX,143,2212,3,2355,1,388,60,448
20200319,UT,78,1448,0,1526,0,1317,15,1332
20200319,VA,94,1829,2,1923,1,628,17,645
20200319,VI,3,,,3,0,0,1,1
20200319,VT,22,645,,667,0,53,3,56
20200319,WA,2461,36045,92,38506,10,4228,332,4560
20200319,WI,155,2192,,2347,0,615,49,664
20200319,WV,2,143,0,148,0,21,1,22
20200319,WY,18,271,,289,0,93,3,96
20200318,AK,6,406,0,412,0,72,3,75
20200318,AL,46,28,0,74,0,0,10,10
20200318,AR,33,236,,319,0,39,11,50
20200318,AS,,,0,0,0,0,0,0
20200318,AZ,28,148,0,278,0,6,8,14
20200318,CA,611,7981,13,8592,2,0,128,128
20200318,CO,183,1617,2,1800,1,561,23,584
20200318,CT,68,125,,193,0,0,27,27
20200318,DC,31,138,,170,0,34,9,43
20200318,DE,25,36,,61,0,0,9,9
20200318,FL,314,1225,7,2493,1,285,128,413
20200318,GA,197,1311,1,1508,0,1311,51,1362
20200318,GU,8,57,,65,0,16,3,19
20200318,HI,14,93,,107,0,93,4,97
20200318,IA,29,83,,112,0,0,6,6
20200318,ID,9,459,,468,0,113,2,115
20200318,IL,288,1763,1,2051,0,423,129,552
20200318,IN,39,154,2,193,0,25,9,34
20200318,KS,16,417,1,433,0,35,1,36
20200318,KY,26,354,1,380,0,59,4,63
20200318,LA,240,335,6,575,2,49,103,152
20200318,MA,156,2115,2,2271,2,482,38,520
20200318,MD,85,94,,179,0,0,28,28
20200318,ME,43,1670,,1713,0,367,11,378
20200318,MI,2913,1215,,4128,0,589,520,1109
20200318,MN,77,2685,,2762,0,409,17,426
20200318,MO,13,253,0,266,0,46,5,51
20200318,MP,0,,0,0,0,0,0,0
20200318,MS,34,479,,513,0,111,13,124
20200318,MT,10,499,,509,0,196,2,198
20200318,NC,63,1787,0,1850,0,1313,23,1336
20200318,ND,6,268,0,274,0,48,3,51
20200318,NE,24,206,,230,0,0,3,3
20200318,NH,26,513,,747,0,158,9,167
20200318,NJ,427,190,5,638,2,27,160,187
20200318,NM,28,2326,,2354,0,1077,5,1082
20200318,NV,55,168,1,223,0,0,0,0
20200318,NY,2382,12215,12,14597,5,6709,682,7391
20200318,OH,88,140,,228,0,0,21,21
20200318,OK,29,378,,517,0,131,12,143
20200318,OR,75,1118,3,1554,3,429,28,457
20200318,PA,133,1187,1,1320,1,308,37,345
20200318,PR,5,31,,57,0,18,0,18
20200318,RI,33,540,,907,0,137,10,147
20200318,SC,60,583,1,643,0,272,27,299
20200318,SD,11,551,1,912,1,0,0,0
20200318,TN,98,349,,447,0,19,25,44
20200318,TX,83,1824,2,1907,1,620,19,639
20200318,UT,63,131,0,194,0,0,12,12
20200318,VA,77,1201,1,1278,0,240,10,250
20200318,VI,2,,,2,0,0,0,0
20200318,VT,19,592,,611,0,97,9,106
20200318,WA,2129,31817,82,33946,4,4468,289,4757
20200318,WI,106,1577,,1683,0,539,34,573
20200318,WV,1,122,0,137,0,42,1,43
20200318,WY,15,178,,193,0,83,5,88
20200317,AK,3,334,0,337,0,191,2,193
20200317,AL,36,28,0,64,0,0,8,8
20200317,AR,22,197,,260,0,65,0,65
20200317,AS,,,,0,0,0,0,0
20200317,AZ,20,142,0,228,0,17,2,19
20200317,CA,483,7981,11,8464,5,0,148,148
20200317,CO,160,1056,1,1216,0,429,29,458
20200317,CT,41,125,,166,0,0,15,15
20200317,DC,22,104,,126,0,8,5,13
20200317,DE,16,36,,52,0,0,8,8
20200317,FL,186,940,6,1998,2,256,45,301
20200317,GA,146,,1,146,0,0,25,25
20200317,GU,5,41,,46,0,18,2,20
20200317,HI,10,,,10,0,0,3,3
20200317,IA,23,83,,106,0,0,1,1
20200317,ID,7,346,,353,0,81,2,83
20200317,IL,159,1340,1,1499,1,408,66,474
20200317,IN,30,129,2,159,1,14,6,20
20200317,KS,15,382,1,397,0,216,4,220
20200317,KY,22,295,1,317,0,61,1,62
20200317,LA,137,286,4,423,2,98,22,120
20200317,MA,118,1633,,1751,0,434,21,455
20200317,MD,57,94,,151,0,0,20,20
20200317,ME,32,1303,,1335,0,539,15,554
20200317,MI,2393,626,,3019,0,354,460,814
20200317,MN,60,2276,,2336,0,437,6,443
20200317,MO,8,207,0,215,0,43,2,45
20200317,MP,0,,,0,0,0,0,0
20200317,MS,21,368,,389,0,91,9,100
20200317,MT,8,303,,311,0,105,1,106
20200317,NC,40,474,0,514,0,178,7,185
20200317,ND,3,220,0,223,0,97,2,99
20200317,NE,21,206,,227,0,36,3,39
20200317,NH,17,355,,567,0,84,4,88
20200317,NJ,267,163,3,485,1,43,89,132
20200317,NM,23,1249,,1272,0,683,6,689
20200317,NV,55,168,1,223,0,0,10,10
20200317,NY,1700,5506,7,7206,0,963,750,1713
20200317,OH,67,140,,207,0,0,17,17
20200317,OK,17,247,,346,0,73,7,80
20200317,OR,47,689,,920,0,110,8,118
20200317,PA,96,879,,975,0,209,20,229
20200317,PR,5,13,,22,0,4,0,4
20200317,RI,23,403,,575,0,95,2,97
20200317,SC,33,311,1,344,0,76,5,81
20200317,SD,11,551,,597,0,57,1,58
20200317,TN,73,330,,403,0,60,21,81
20200317,TX,64,1204,1,1268,1,1204,7,1211
20200317,UT,51,131,0,182,0,0,12,12
20200317,VA,67,961,1,1028,0,523,16,539
20200317,VI,2,,,2,0,0,1,1
20200317,VT,10,495,,505,0,74,2,76
20200317,WA,1840,27349,78,29189,9,4389,263,4652
20200317,WI,72,1038,,1110,0,534,25,559
20200317,WV,0,80,0,84,0,0,0,0
20200317,WY,10,95,,105,0,95,7,102
20200316,AK,1,143,0,144,0,0,0,0
20200316,AL,28,28,0,96,0,0,16,16
20200316,AR,22,132,,168,0,29,6,35
20200316,AS,,,,0,,,,
20200316,AZ,18,125,0,206,0,4,6,10
20200316,CA,335,7981,6,8316,1,7065,42,7107
20200316,CO,131,627,1,758,0,0,0,0
20200316,CT,26,125,,151,0,0,6,6
20200316,DC,17,96,,120,0,17,1,18
20200316,DE,8,36,,76,0,0,2,2
20200316,FL,141,684,4,1339,0,6,25,31
20200316,GA,121,,1,121,0,0,22,22
20200316,GU,3,23,,26,,,,
20200316,HI,7,,,7,0,0,5,5
20200316,IA,22,83,,105,0,0,4,4
20200316,ID,5,265,,270,0,91,0,91
20200316,IL,93,932,,1025,0,483,29,512
20200316,IN,24,115,1,139,1,13,5,18
20200316,KS,11,166,1,177,0,31,3,34
20200316,KY,21,234,1,255,1,95,5,100
20200316,LA,115,188,2,303,0,32,25,57
20200316,MA,97,1199,,1296,0,615,33,648
20200316,MD,37,94,,131,0,0,6,6
20200316,ME,17,764,,781,0,673,14,687
20200316,MI,1933,272,,2235,0,67,453,520
20200316,MN,54,1839,,1893,0,452,19,471
20200316,MO,6,164,0,170,0,42,1,43
20200316,MP,0,,,0,,,,
20200316,MS,12,277,,289,0,193,2,195
20200316,MT,7,198,,205,0,95,0,95
20200316,NC,33,296,0,480,0,69,1,70
20200316,ND,1,123,0,124,0,28,0,28
20200316,NE,18,170,,188,0,90,1,91
20200316,NH,13,271,,379,0,0,0,0
20200316,NJ,178,120,2,318,0,0,80,80
20200316,NM,17,566,,583,0,84,4,88
20200316,NV,45,168,1,213,1,0,24,24
20200316,NY,950,4543,7,5493,4,0,221,221
20200316,OH,50,140,,551,0,1,14,15
20200316,OK,10,174,,213,0,56,1,57
20200316,OR,39,579,,800,0,159,3,162
20200316,PA,76,670,,746,0,465,13,478
20200316,PR,5,9,,14,,,,
20200316,RI,21,308,,478,0,37,1,38
20200316,SC,28,235,1,263,1,81,9,90
20200316,SD,10,494,,504,0,167,1,168
20200316,TN,52,270,,322,0,113,13,126
20200316,TX,57,,,57,0,0,1,1
20200316,UT,39,131,0,170,0,0,11,11
20200316,VA,51,438,1,489,0,75,6,81
20200316,VI,1,,,1,,,,
20200316,VT,8,421,,429,0,73,4,77
20200316,WA,1577,22960,69,24537,12,4604,300,4904
20200316,WI,47,504,,551,0,191,14,205
20200316,WV,0,80,0,84,0,42,0,42
20200316,WY,3,,,3,0,0,0,0
20200315,AK,1,143,0,144,0,0,0,0
20200315,AL,12,28,0,86,0,6,6,12
20200315,AR,16,103,,149,0,38,4,42
20200315,AZ,12,121,0,183,0,0,0,0
20200315,CA,293,916,5,1209,0,0,41,41
20200315,CO,131,627,1,758,0,17,30,47
20200315,CT,20,125,,145,0,0,9,9
20200315,DC,16,79,,115,0,30,6,36
20200315,DE,6,36,,74,0,0,0,0
20200315,FL,116,678,4,1248,1,200,39,239
20200315,GA,99,,1,99,0,0,33,33
20200315,HI,2,,,2,0,0,0,0
20200315,IA,18,83,,101,0,0,1,1
20200315,ID,5,174,,179,0,0,3,3
20200315,IL,64,449,,708,0,133,18,151
20200315,IN,19,102,0,121,0,28,4,32
20200315,KS,8,135,1,143,0,42,2,44
20200315,KY,16,139,,155,0,0,2,2
20200315,LA,90,156,2,246,2,47,39,86
20200315,MA,64,584,,648,0,584,26,610
20200315,MD,31,94,,125,0,0,5,5
20200315,ME,3,91,,111,0,0,0,0
20200315,MI,1480,205,,1711,0,0,284,284
20200315,MN,35,1387,,1422,0,540,14,554
20200315,MO,5,122,0,127,0,32,1,33
20200315,MS,10,84,,94,0,0,4,4
20200315,MT,7,103,,167,0,0,2,2
20200315,NC,32,227,,410,0,90,9,99
20200315,ND,1,95,0,100,0,41,0,41
20200315,NE,17,80,,130,0,0,3,3
20200315,NH,13,271,,379,0,59,6,65
20200315,NJ,98,120,2,252,1,23,48,71
20200315,NM,13,482,,495,0,245,3,248
20200315,NV,21,168,,353,0,0,1,1
20200315,NY,729,4543,3,5272,3,1764,205,1969
20200315,OH,36,139,,525,0,89,23,112
20200315,OK,9,118,,139,0,82,5,87
20200315,OR,36,420,,681,0,83,6,89
20200315,PA,63,205,,451,0,0,16,16
20200315,RI,20,271,,348,0,73,0,73
20200315,SC,19,154,,173,0,44,6,50
20200315,SD,9,327,,342,0,145,0,145
20200315,TN,39,157,,196,0,27,7,34
20200315,TX,56,,,56,0,0,5,5
20200315,UT,28,131,0,159,0,0,22,22
20200315,VA,45,363,1,408,1,246,15,261
20200315,VT,4,348,,352,0,121,0,121
20200315,WA,1277,18356,57,19633,6,1587,106,1693
20200315,WI,33,313,,346,0,144,14,158
20200315,WV,0,38,0,39,0,12,0,12
20200315,WY,3,,,3,0,0,1,1
20200314,AK,1,143,0,144,0,84,0,84
20200314,AL,6,22,,74,0,11,5,16
20200314,AR,12,65,,103,0,35,3,38
20200314,AZ,12,121,0,183,0,27,3,30
20200314,CA,252,916,5,1168,1,0,50,50
20200314,CO,101,610,1,711,1,86,29,115
20200314,CT,11,125,,136,0,26,5,31
20200314,DC,10,49,,69,0,29,0,29
20200314,DE,6,36,,74,0,6,2,8
20200314,FL,77,478,3,776,1,0,27,27
20200314,GA,66,,1,66,0,0,24,24
20200314,HI,2,,,2,0,0,0,0
20200314,IA,17,83,,100,0,0,1,1
20200314,ID,2,174,,176,0,43,2,45
20200314,IL,46,316,,444,0,22,14,36
20200314,IN,15,74,0,89,0,13,3,16
20200314,KS,6,93,1,99,1,0,0,0
20200314,KY,14,139,,153,0,32,3,35
20200314,LA,51,109,,160,0,72,15,87
20200314,MA,38,,,38,0,0,15,15
20200314,MD,26,94,,120,0,0,9,9
20200314,ME,3,91,,111,0,0,0,0
20200314,MI,1196,205,,1427,0,72,251,323
20200314,MN,21,847,,868,0,306,7,313
20200314,MO,4,90,0,94,0,19,2,21
20200314,MS,6,84,,90,0,43,2,45
20200314,MT,5,103,,108,0,48,4,52
20200314,NC,23,137,,160,0,51,8,59
20200314,ND,1,54,0,69,0,15,0,15
20200314,NE,14,80,,127,0,0,1,1
20200314,NH,7,212,,250,0,118,1,119
20200314,NJ,50,97,1,227,0,0,0,0
20200314,NM,10,237,,247,0,47,0,47
20200314,NV,20,168,,188,0,0,9,9
20200314,NY,524,2779,,3303,0,0,103,103
20200314,OH,13,50,,222,0,0,0,0
20200314,OK,4,36,,77,0,0,1,1
20200314,OR,30,337,,524,0,0,0,0
20200314,PA,47,205,,402,0,65,6,71
20200314,RI,20,198,,275,0,56,6,62
20200314,SC,13,110,,123,0,35,1,36
20200314,SD,9,182,,194,0,109,0,109
20200314,TN,32,130,,162,0,14,6,20
20200314,TX,51,,,51,0,0,12,12
20200314,UT,6,131,,137,0,0,0,0
20200314,VA,30,117,,147,0,0,0,0
20200314,VT,4,227,,231,0,85,2,87
20200314,WA,1171,16769,51,17940,4,2183,156,2339
20200314,WI,19,169,,188,0,0,0,0
20200314,WV,0,26,,31,0,9,0,9
20200314,WY,2,,,2,0,0,1,1
20200313,AK,1,59,0,60,0,13,1,14
20200313,AL,1,11,,12,0,1,1,2
20200313,AR,9,30,,61,0,6,3,9
20200313,AZ,9,94,0,143,0,12,0,12
20200313,CA,202,916,4,1118,0,0,0,0
20200313,CO,72,524,,596,0,226,27,253
20200313,CT,6,99,,105,0,10,0,10
20200313,DC,10,20,,30,0,0,0,0
20200313,DE,4,30,,44,0,7,0,7
20200313,FL,50,478,2,749,0,177,18,195
20200313,GA,42,,1,42,1,0,11,11
20200313,HI,2,,,2,0,0,0,0
20200313,IA,16,83,,128,0,16,2,18
20200313,ID,0,131,,131,0,38,0,38
20200313,IL,32,294,,418,0,28,7,35
20200313,IN,12,61,,73,0,9,0,9
20200313,KS,6,93,,99,0,52,2,54
20200313,KY,11,107,,118,0,51,3,54
20200313,LA,36,37,,73,0,0,22,22
20200313,MA,23,,,23,0,0,15,15
20200313,MD,17,94,,111,0,0,5,5
20200313,ME,3,91,,111,0,26,2,28
20200313,MI,945,133,,1104,0,42,243,285
20200313,MN,14,541,,555,0,234,5,239
20200313,MO,2,71,,73,0,7,1,8
20200313,MS,4,41,,45,0,0,3,3
20200313,MT,1,55,,56,0,21,0,21
20200313,NC,15,86,,101,0,26,3,29
20200313,ND,1,39,0,52,0,27,0,27
20200313,NE,13,80,,126,0,0,3,3
20200313,NH,6,94,,121,0,0,0,0
20200313,NJ,50,97,1,227,0,23,20,43
20200313,NM,10,190,,200,0,35,5,40
20200313,NV,11,168,,179,0,0,4,4
20200313,NY,421,2779,,3200,0,2687,205,2892
20200313,OH,13,50,,222,0,20,8,28
20200313,OK,3,36,,76,0,0,0,0
20200313,OR,30,337,,524,0,51,11,62
20200313,PA,41,140,,311,0,24,19,43
20200313,RI,14,142,,185,0,48,9,57
20200313,SC,12,75,,87,0,27,2,29
20200313,SD,9,73,,93,0,46,1,47
20200313,TN,26,116,,142,0,37,8,45
20200313,TX,39,,,39,0,0,16,16
20200313,UT,6,131,,137,0,0,2,2
20200313,VA,30,117,,147,0,0,13,13
20200313,VT,2,142,,144,0,45,0,45
20200313,WA,1015,14586,47,15601,3,4023,216,4239
20200313,WI,19,169,,188,0,85,11,96
20200313,WV,0,17,,21,0,10,0,10
20200313,WY,1,,,1,0,0,0,0
20200312,AK,0,46,0,60,0,0,0,0
20200312,AL,0,10,,10,0,0,0,0
20200312,AR,6,24,,50,0,12,6,18
20200312,AZ,9,82,,115,0,23,0,23
20200312,CA,202,916,4,1118,4,0,45,45
20200312,CO,45,298,,343,0,47,17,64
20200312,CT,6,89,,95,0,18,3,21
20200312,DC,10,20,,30,0,0,5,5
20200312,DE,4,23,,41,0,6,3,9
20200312,FL,32,301,2,480,0,0,4,4
20200312,GA,31,,,31,0,0,9,9
20200312,HI,2,,,2,0,0,0,0
20200312,IA,14,67,,105,0,21,1,22
20200312,ID,0,93,,93,0,26,0,26
20200312,IL,25,266,,367,0,22,6,28
20200312,IN,12,52,,64,0,19,2,21
20200312,KS,4,41,,45,0,0,3,3
20200312,KY,8,56,,64,0,10,0,10
20200312,LA,14,37,,51,0,0,8,8
20200312,MA,8,,,8,,,,
20200312,MD,12,94,,106,0,0,3,3
20200312,ME,1,65,,86,0,23,1,24
20200312,MI,702,91,,820,0,34,205,239
20200312,MN,9,307,,316,0,90,4,94
20200312,MO,1,64,,65,0,64,0,64
20200312,MS,1,41,,42,0,21,1,22
20200312,MT,1,34,,35,0,13,1,14
20200312,NC,12,60,,72,0,60,5,65
20200312,ND,1,12,,27,0,5,1,6
20200312,NE,10,80,,123,0,33,5,38
20200312,NH,6,94,,121,0,56,2,58
20200312,NJ,30,74,1,124,0,17,6,23
20200312,NM,5,155,,160,0,68,2,70
20200312,NV,7,168,,175,0,0,2,2
20200312,NY,216,92,,308,0,0,0,0
20200312,OH,5,30,,87,0,9,1,10
20200312,OK,3,36,,43,0,21,1,22
20200312,OR,19,286,,367,0,0,0,0
20200312,PA,22,116,,219,0,28,6,34
20200312,RI,5,94,,107,0,0,0,0
20200312,SC,10,48,,58,0,16,1,17
20200312,SD,8,27,,46,0,14,3,17
20200312,TN,18,79,,97,0,29,11,40
20200312,TX,23,,,23,0,0,2,2
20200312,UT,4,131,,135,0,131,2,133
20200312,VA,17,117,,134,0,57,8,65
20200312,VT,2,97,,99,0,35,1,36
20200312,WA,799,10563,44,11362,4,3588,178,3766
20200312,WI,8,84,,92,0,41,5,46
20200312,WV,0,7,,8,0,4,0,4
20200312,WY,1,,,1,0,0,1,1
20200311,AK,0,46,0,60,0,23,0,23
20200311,AL,0,10,,10,0,10,0,10
20200311,AR,0,12,,26,0,0,0,0
20200311,AZ,9,59,,100,0,8,3,11
20200311,CA,157,916,,1073,0,226,24,250
20200311,CO,28,251,,279,0,109,16,125
20200311,CT,3,71,,74,0,17,1,18
20200311,DC,5,20,,40,0,3,0,3
20200311,DE,1,17,,20,0,0,1,1
20200311,FL,28,301,2,476,2,79,9,88
20200311,GA,22,,,22,0,0,5,5
20200311,HI,2,,,2,0,0,0,0
20200311,IA,13,46,,86,0,14,5,19
20200311,ID,0,67,,67,0,26,0,26
20200311,IL,19,244,,326,0,0,0,0
20200311,IN,10,33,,43,0,3,4,7
20200311,KS,1,41,,42,0,24,0,24
20200311,KY,8,46,,54,0,18,2,20
20200311,LA,6,37,,43,0,26,5,31
20200311,MD,9,94,,103,0,5,3,8
20200311,ME,0,42,,47,0,22,0,22
20200311,MI,497,57,,572,0,18,139,157
20200311,MN,5,217,,222,0,85,2,87
20200311,MO,1,,,1,0,0,0,0
20200311,MS,0,20,,20,0,20,0,20
20200311,MT,0,21,,21,0,6,0,6
20200311,NC,7,,,7,0,0,0,0
20200311,ND,0,7,,13,0,1,0,1
20200311,NE,5,47,,68,0,0,2,2
20200311,NH,4,38,,47,0,0,0,0
20200311,NJ,24,57,1,101,1,13,9,22
20200311,NM,3,87,,90,0,18,3,21
20200311,NV,5,168,,173,0,154,4,158
20200311,NY,216,92,,308,0,0,43,43
20200311,OH,4,21,,49,0,7,1,8
20200311,OK,2,15,,28,0,0,0,0
20200311,OR,19,286,,367,0,73,4,77
20200311,PA,16,88,,158,0,88,4,92
20200311,RI,5,94,,123,0,36,2,38
20200311,SC,9,32,,41,0,8,2,10
20200311,SD,5,13,,20,0,2,5,7
20200311,TN,7,50,,57,0,50,0,50
20200311,TX,21,,,21,0,0,8,8
20200311,UT,2,,,2,0,0,0,0
20200311,VA,9,60,,69,0,7,1,8
20200311,VT,1,62,,63,0,22,0,22
20200311,WA,621,6975,40,7596,3,2128,133,2261
20200311,WI,3,43,,46,0,7,1,8
20200311,WV,0,3,,5,0,1,0,1
20200311,WY,0,,,0,0,0,0,0
20200310,AK,0,23,0,32,0,0,0,0
20200310,AL,0,0,,0,0,0,0,0
20200310,AR,0,12,,15,0,0,0,0
20200310,AZ,6,51,,84,0,7,1,8
20200310,CA,133,690,,823,0,0,19,19
20200310,CO,12,142,,155,0,9,3,12
20200310,CT,2,54,,56,0,8,1,9
20200310,DC,5,17,,24,0,3,4,7
20200310,DE,0,17,,20,0,2,0,2
20200310,FL,19,222,,396,0,82,1,83
20200310,GA,17,,,17,0,0,5,5
20200310,HI,2,,,2,0,0,0,0
20200310,IA,8,32,,51,0,6,5,11
20200310,ID,0,41,,41,0,0,0,0
20200310,IL,19,244,,326,0,53,12,65
20200310,IN,6,30,,36,0,30,4,34
20200310,KS,1,17,,39,0,6,0,6
20200310,KY,6,28,,34,0,11,2,13
20200310,LA,1,11,,12,0,6,0,6
20200310,MD,6,89,,95,0,16,1,17
20200310,ME,0,20,,25,0,19,0,19
20200310,MI,358,39,,421,0,3,104,107
20200310,MN,3,132,,135,0,52,1,53
20200310,MO,1,,,1,0,0,0,0
20200310,MS,0,,,0,0,0,0,0
20200310,MT,0,15,,15,0,4,0,4
20200310,NC,7,,,7,0,0,5,5
20200310,ND,0,6,,8,0,6,0,6
20200310,NE,3,47,,66,0,11,0,11
20200310,NH,4,38,,47,0,0,0,0
20200310,NJ,15,44,,79,0,9,4,13
20200310,NM,0,69,,69,0,12,0,12
20200310,NV,1,14,,15,0,0,0,0
20200310,NY,173,92,,265,0,0,31,31
20200310,OH,3,14,,32,0,3,0,3
20200310,OK,2,15,,28,0,7,1,8
20200310,OR,15,213,,295,0,48,1,49
20200310,PA,12,,,12,0,0,2,2
20200310,RI,3,58,,67,0,28,0,28
20200310,SC,7,24,,31,0,0,0,0
20200310,SD,0,11,,11,0,6,0,6
20200310,TN,7,,,7,0,0,4,4
20200310,TX,13,,,13,0,0,1,1
20200310,UT,2,,,2,0,0,1,1
20200310,VA,8,53,,61,0,15,5,20
20200310,VT,1,40,,41,0,6,0,6
20200310,WA,488,4847,37,5335,2,1675,110,1785
20200310,WI,2,36,,38,0,0,1,1
20200310,WV,0,2,,5,0,0,0,0
20200310,WY,0,0,,0,0,0,0,0
20200309,AK,0,23,0,32,0,9,0,9
20200309,AL,0,,,0,0,0,0,0
20200309,AR,0,12,,12,0,6,0,6
20200309,AZ,5,44,,56,0,0,0,0
20200309,CA,114,690,,804,0,228,26,254
20200309,CO,9,133,,142,0,29,1,30
20200309,CT,1,46,,47,0,17,0,17
20200309,DC,1,14,,18,0,4,0,4
20200309,DE,0,15,,18,0,5,0,5
20200309,FL,18,140,,273,0,22,1,23
20200309,GA,12,,,12,0,0,5,5
20200309,HI,2,,,2,0,0,1,1
20200309,IA,3,26,,37,0,11,3,14
20200309,ID,0,41,,41,0,14,0,14
20200309,IL,7,191,,242,0,0,1,1
20200309,IN,2,,,2,0,0,0,0
20200309,KS,1,11,,12,0,0,0,0
20200309,KY,4,17,,21,0,4,3,7
20200309,LA,1,5,,6,0,0,1,1
20200309,MD,5,73,,78,0,21,2,23
20200309,ME,0,1,,1,0,0,0,0
20200309,MI,254,36,,301,0,10,86,96
20200309,MN,2,80,,82,0,32,1,33
20200309,MO,1,,,1,0,0,0,0
20200309,MS,0,,,0,0,0,0,0
20200309,MT,0,11,,11,0,0,0,0
20200309,NC,2,,,2,0,0,0,0
20200309,ND,0,0,,0,0,0,0,0
20200309,NE,3,36,,48,0,19,2,21
20200309,NH,4,38,,47,0,0,0,0
20200309,NJ,11,35,,60,0,4,5,9
20200309,NM,0,57,,57,0,9,0,9
20200309,NV,1,14,,15,0,0,0,0
20200309,NY,142,92,,234,0,0,37,37
20200309,OH,3,11,,19,0,1,3,4
20200309,OK,1,8,,19,0,0,0,0
20200309,OR,14,165,,231,0,65,0,65
20200309,PA,10,,,10,0,0,4,4
20200309,RI,3,30,,39,0,0,0,0
20200309,SC,7,24,,31,0,16,5,21
20200309,SD,0,5,,5,0,0,0,0
20200309,TN,3,,,3,0,0,0,0
20200309,TX,12,,,12,0,0,4,4
20200309,UT,1,,,1,0,0,0,0
20200309,VA,3,38,,50,0,2,1,3
20200309,VT,1,34,,35,0,6,0,6
20200309,WA,378,3172,35,3550,4,964,61,1025
20200309,WI,1,36,,37,0,5,0,5
20200309,WV,0,2,,5,0,0,0,0
20200309,WY,0,,,0,0,0,0,0
20200308,AK,0,14,0,20,0,2,0,2
20200308,AL,0,,,0,0,0,0,0
20200308,AR,0,6,,6,0,0,0,0
20200308,AZ,5,44,,56,0,0,0,0
20200308,CA,88,462,,550,0,0,19,19
20200308,CO,8,104,,112,0,49,0,49
20200308,CT,1,29,,38,0,29,1,30
20200308,DC,1,10,,11,0,2,1,3
20200308,DE,0,10,,10,0,0,0,0
20200308,FL,17,118,,243,0,18,3,21
20200308,GA,7,,,7,0,0,1,1
20200308,HI,1,,,1,0,0,0,0
20200308,IA,0,15,,17,0,0,0,0
20200308,ID,0,27,,27,0,0,0,0
20200308,IL,6,191,,241,0,0,0,0
20200308,IN,2,,,2,0,0,1,1
20200308,KS,1,11,,12,0,0,1,1
20200308,KY,1,13,,14,0,4,0,4
20200308,LA,0,5,,5,0,5,0,5
20200308,MD,3,52,,55,0,11,0,11
20200308,ME,0,1,,1,0,0,0,0
20200308,MI,168,26,,204,0,8,40,48
20200308,MN,1,48,,49,0,0,0,0
20200308,MO,1,,,1,0,0,1,1
20200308,MS,0,,,0,0,0,0,0
20200308,MT,0,11,,11,0,0,0,0
20200308,NC,2,,,2,0,0,0,0
20200308,ND,0,0,,0,0,0,0,0
20200308,NE,1,17,,23,0,0,0,0
20200308,NH,4,38,,47,0,18,2,20
20200308,NJ,6,31,,37,0,31,2,33
20200308,NM,0,48,,48,0,0,0,0
20200308,NV,1,14,,15,0,0,0,0
20200308,NY,105,92,,197,0,0,29,29
20200308,OH,0,10,,14,0,1,0,1
20200308,OK,1,8,,11,0,8,0,8
20200308,OR,14,100,,167,0,23,7,30
20200308,PA,6,,,6,0,0,2,2
20200308,RI,3,30,,45,0,0,1,1
20200308,SC,2,8,,10,0,0,0,0
20200308,SD,0,5,,5,0,0,0,0
20200308,TN,3,,,3,0,0,2,2
20200308,TX,8,,,8,0,0,0,0
20200308,UT,1,,,1,0,0,0,0
20200308,VA,2,36,,44,0,5,2,7
20200308,VT,1,28,,29,0,12,1,13
20200308,WA,317,2208,31,2585,4,462,61,523
20200308,WI,1,31,,44,0,0,0,0
20200308,WV,0,2,,5,0,0,0,0
20200308,WY,0,,,0,0,0,0,0
20200307,AK,0,12,0,14,0,4,0,4
20200307,AL,0,,,0,,,,
20200307,AR,0,6,,6,0,0,0,0
20200307,AZ,5,44,,56,0,11,2,13
20200307,CA,69,462,,531,0,0,9,9
20200307,CO,8,55,,132,0,9,6,15
20200307,CT,0,,,0,,,,
20200307,DC,0,8,,9,0,0,0,0
20200307,DE,0,10,,10,0,0,0,0
20200307,FL,14,100,,202,0,45,5,50
20200307,GA,6,,,6,0,0,4,4
20200307,HI,1,,,1,,,,
20200307,IA,0,15,,17,0,0,0,0
20200307,ID,0,27,,27,,,,
20200307,IL,6,191,,241,0,11,1,12
20200307,IN,1,,,1,0,0,0,0
20200307,KS,0,11,,13,0,7,0,7
20200307,KY,1,9,,10,0,2,1,3
20200307,LA,0,,,0,,,,
20200307,MD,3,41,,44,0,15,0,15
20200307,ME,0,1,,1,,,,
20200307,MI,128,18,,155,0,10,30,40
20200307,MN,1,48,,49,0,12,1,13
20200307,MO,0,,,0,,,,
20200307,MS,0,,,0,,,,
20200307,MT,0,11,,11,,,,
20200307,NC,2,,,2,0,0,0,0
20200307,ND,0,0,,0,,,,
20200307,NE,1,17,,23,0,0,1,1
20200307,NH,2,20,,25,0,0,0,0
20200307,NJ,4,,,5,0,0,3,3
20200307,NM,0,48,,48,0,32,0,32
20200307,NV,1,14,,15,0,0,0,0
20200307,NY,76,92,,404,0,0,43,43
20200307,OH,0,9,,14,0,1,0,1
20200307,OK,1,,,1,,,,
20200307,OR,7,77,,124,0,13,4,17
20200307,PA,4,,,4,0,0,2,2
20200307,RI,2,30,,32,0,13,-1,12
20200307,SC,2,8,,10,0,3,2,5
20200307,SD,0,5,,5,,,,
20200307,TN,1,,,1,0,0,0,0
20200307,TX,8,,,8,0,0,3,3
20200307,UT,1,,,1,,,,
20200307,VA,0,31,,38,0,10,0,10
20200307,VT,0,16,,16,0,8,0,8
20200307,WA,256,1746,27,2068,1,367,38,405
20200307,WI,1,31,,44,0,0,0,0
20200307,WV,0,2,,5,0,1,0,1
20200307,WY,0,,,0,,,,
20200306,AK,0,8,0,9,,,,
20200306,AR,0,6,,6,,,,
20200306,AZ,3,33,,51,0,5,1,6
20200306,CA,60,462,,522,0,0,7,7
20200306,CO,2,46,,78,0,27,2,29
20200306,DC,0,8,,9,0,2,0,2
20200306,DE,0,10,,10,,,,
20200306,FL,9,55,,115,0,24,0,24
20200306,GA,2,,,2,0,0,0,0
20200306,IA,0,15,,17,,,,
20200306,IL,5,180,,220,0,15,0,15
20200306,IN,1,,,1,,,,
20200306,KS,0,4,,4,,,,
20200306,KY,0,7,,10,,,,
20200306,MD,3,26,,41,0,9,3,12
20200306,MI,98,8,,114,0,0,26,26
20200306,MN,0,36,,36,,,,
20200306,NC,2,,,2,0,0,1,1
20200306,NE,0,17,,22,0,0,0,0
20200306,NH,2,20,,25,0,4,0,4
20200306,NJ,1,,,1,0,0,0,0
20200306,NM,0,16,,16,,,,
20200306,NV,1,14,,15,0,0,0,0
20200306,NY,33,92,,361,0,16,11,27
20200306,OH,0,8,,10,0,1,0,1
20200306,OR,3,64,,95,0,19,0,19
20200306,PA,2,,,2,,,,
20200306,RI,3,17,,20,0,0,1,1
20200306,SC,0,5,,5,0,0,0,0
20200306,TN,1,,,1,0,0,0,0
20200306,TX,5,,,5,0,0,4,4
20200306,VA,0,21,,31,0,3,0,3
20200306,VT,0,8,,8,,,,
20200306,WA,218,1379,26,1597,6,435,39,474
20200306,WI,1,31,,44,0,12,0,12
20200306,WV,0,1,,5,,,,
20200305,AZ,2,28,,36,0,1,0,1
20200305,CA,53,462,,515,0,0,0,0
20200305,CO,0,19,,40,,,,
20200305,DC,0,6,,8,,,,
20200305,FL,9,31,,109,0,7,7,14
20200305,GA,2,,,2,0,0,0,0
20200305,IL,5,165,,197,0,41,1,42
20200305,MD,0,17,,31,,,,
20200305,MI,72,8,,80,0,8,20,28
20200305,NC,1,,,1,0,0,0,0
20200305,NE,0,17,,22,,,,
20200305,NH,2,16,,22,0,6,0,6
20200305,NJ,1,,,1,,,,
20200305,NV,1,14,,15,,,,
20200305,NY,22,76,,122,0,28,16,44
20200305,OH,0,7,,10,,,,
20200305,OR,3,45,,61,0,16,0,16
20200305,RI,2,17,,19,0,6,0,6
20200305,SC,0,5,,5,0,0,0,0
20200305,TN,1,,,1,,,,
20200305,TX,1,,,1,0,0,0,0
20200305,VA,0,18,,21,,,,
20200305,WA,179,944,20,1123,4,311,51,362
20200305,WI,1,19,,26,0,0,0,0
20200304,AZ,2,27,,34,,,,
20200304,CA,53,462,,515,,,,
20200304,FL,2,24,,42,,,,
20200304,GA,2,,,2,,,,
20200304,IL,4,124,,155,,,,
20200304,MI,52,,,52,0,0,18,18
20200304,NC,1,,,1,,,,
20200304,NH,2,10,,19,,,,
20200304,NY,6,48,,78,,,,
20200304,OR,3,29,,50,,,,
20200304,RI,2,11,,13,0,5,0,5
20200304,SC,0,5,,5,,,,
20200304,TX,1,,,1,,,,
20200304,WA,128,633,16,761,2,206,38,244
20200304,WI,1,19,,26,,,,
20200303,MI,34,,,34,0,0,16,16
20200303,RI,2,6,,8,0,6,1,7
20200303,WA,90,427,14,517,3,198,25,223
20200302,MI,18,,,18,0,0,9,9
20200302,RI,1,,,1,0,0,0,0
20200302,WA,65,229,11,294,3,148,31,179
20200301,MI,9,,,9,,,,
20200301,RI,1,,,1,,,,
20200301,WA,34,81,8,115,3,58,16,74
20200229,WA,18,23,5,41,1,23,9,32
20200228,WA,9,,4,9,2,0,7,7
20200227,WA,2,,2,2,0,0,0,0
20200226,WA,2,,2,2,2,0,0,0
20200225,WA,2,,,2,0,0,0,0
20200224,WA,2,,,2,0,0,0,0
20200223,WA,2,,,2,0,0,0,0
20200222,WA,2,,,2,0,0,0,0
20200221,WA,2,,,2,0,0,0,0
20200220,WA,2,,,2,0,0,0,0
20200219,WA,2,,,2,0,0,0,0
20200218,WA,2,,,2,0,0,0,0
20200217,WA,2,,,2,0,0,0,0
20200216,WA,2,,,2,0,0,0,0
20200215,WA,2,,,2,0,0,0,0
20200214,WA,2,,,2,0,0,0,0
20200213,WA,2,,,2,0,0,0,0
20200212,WA,2,,,2,0,0,0,0
20200211,WA,2,,,2,0,0,0,0
20200210,WA,2,,,2,0,0,0,0
20200209,WA,2,,,2,0,0,0,0
20200208,WA,2,,,2,0,0,0,0
20200207,WA,2,,,2,0,0,1,1
20200206,WA,1,,,1,0,0,0,0
20200205,WA,1,,,1,0,0,0,0
20200204,WA,1,,,1,0,0,0,0
20200203,WA,1,,,1,0,0,0,0
20200202,WA,1,,,1,0,0,0,0
20200201,WA,1,,,1,0,0,0,0
20200131,WA,1,,,1,0,0,0,0
20200130,WA,1,,,1,0,0,0,0
20200129,WA,1,,,1,0,0,0,0
20200128,WA,1,,,1,0,0,0,0
20200127,WA,1,,,1,0,0,0,0
20200126,WA,1,,,1,0,0,0,0
20200125,WA,1,,,1,0,0,0,0
20200124,WA,1,,,1,0,0,0,0
20200123,WA,1,,,1,0,0,0,0
20200122,WA,1,,,1,,,,